Company,Title,Original Price,Current Price,Number of Reviews,Discount Price,Discount Rate,Popularity Ranking
러븀,[1월 올영픽] 러븀 내추럴 블랑 데일리 토너 패드 60매,23000,15000,426,8000,34.8,1
브이티,[아랑Pick] VT 리들샷 100 에센스 50ml,32000,24600,999,7400,23.1,2
데이지크,[NEW 출시] 데이지크 워터 베일 프라이머 40ml,28000,19900,64,8100,28.9,3
달바,[NEW 올영 단독 런칭/쇼케이스 특가] 달바 워터풀 톤업 선크림 퍼플 50ml,34000,19900,10,14100,41.5,4
마녀공장,[3년 연속 1위] 마녀공장 퓨어 클렌징 오일 300mlx2 더블기획,49000,31400,999,17600,35.9,5
에스트라,[NEW/리뷰이벤트] 에스트라 아토베리어365 크림 80ml,33000,26400,86,6600,20.0,6
달바,[쇼케이스 특가] 달바 워터풀 톤업 선크림 듀오 기획(50ml+50ml),51000,35700,999,15300,30.0,7
메디힐,[거울키링증정] 메디힐 패드 100매 (+100매 더블증정 빤쮸토끼 기획) 콜라겐/마데카소사이드/티트리 3종 택1,39900,28400,999,11500,28.8,8
랑벨,랑벨 내츄럴 딥클렌징 스페셜 기획 (클렌징오일200ml+클렌저30ml),19900,15210,999,4690,23.6,9
비플레인,[늘이농 PICK / 단독기획] 비플레인 시카테롤 앰플 30ml 기획(+리필31ml),26000,20800,999,5200,20.0,10
라우쉬,[2023 어워즈] 라우쉬 콜츠푸트 안티-댄드러프 샴푸 200ml 한정 기획,39800,35820,747,3980,10.0,11
클리오,[NEW] 클리오 샤프 쏘 심플 워터프루프 펜슬라이너,11000,7700,999,3300,30.0,12
마녀공장,[민카롱 Pick] 마녀공장 퓨어&딥 클렌징 폼 1+1 기획 (120ml+120ml),12000,10500,999,1500,12.5,13
덴티스테,덴티스테 민트볼 20입,6500,4400,999,2100,32.3,14
뮤드,[NEW컬러] 뮤드 인스파이어 스키니 컬링/멀티 픽서 마스카라,14000,10500,999,3500,25.0,15
에스네이처,[2023어워즈/1+1] 에스네이처 아쿠아 스쿠알란 수분크림 60ml 더블 어워즈 한정기획 (60ml+60ml),43000,23500,999,19500,45.3,16
넘버즈인,[피부결] 넘버즈인 3번 보들보들 결 세럼 80ml 기획(+3번 결 세럼팩),34000,23800,999,10200,30.0,17
롬앤,[2023 어워즈/1위틴트] 롬앤 쥬시 래스팅 틴트,9900,8400,999,1500,15.2,18
코스노리,[NEW컬러] 코스노리 웨이브 틴트 9 colors,15000,12000,999,3000,20.0,19
트리셀,[1월 올영픽] 트리셀 포르테 앰플 트리트먼트 기획세트 (200ml+200ml),28000,20060,422,7940,28.4,20
어노브,[2023 어워즈 헤어케어 1위]어노브 대용량 딥 데미지 트리트먼트 EX 어워즈/듀오/더블 기획3종 택1,42000,28500,999,13500,32.1,21
오쏘몰,오쏘몰 이뮨 멀티비타민&미네랄 7입 (1주분),38000,31800,999,6200,16.3,22
좋은느낌,좋은느낌 유기농 순면커버 라이너  6종 택 1 (롱 / 일반 / 수퍼롱),6500,3580,999,2920,44.9,23
아벤느,아벤느 이드랑스 아쿠아 크림-인-젤 EX 50ml 한정기획 (+이드랑스 에센스인로션 100ml) (와다다곰 콜라보),31000,22900,392,8100,26.1,24
러븀,[1월 올영픽][최모나 PICK] 러븀 카밍 리페어 어린시카 겔 마스크 5매,25000,16700,999,8300,33.2,25
스킨푸드,[한정기획] 스킨푸드 캐롯 카로틴 카밍 워터 패드 기획 (60매+6매증정),26000,17290,999,8710,33.5,26
온더바디,[마루는강쥐X온더바디] 온더바디 발을씻자 코튼 풋샴푸 385ml 2종 택1 (민트향/비누향),11900,5450,999,6450,54.2,27
피지오겔,[더블기획] 피지오겔 DMT 페이셜 크림 100ml+100ml 증정 기획,59000,29900,999,29100,49.3,28
아비브,[NEW] 아비브 껌딱지 시트 마스크 어성초 스티커 1매,4000,2000,999,2000,50.0,29
에스쁘아,[올영픽/민스코 공동개발]에스쁘아 더브로우 밸런스 펜슬 (+미니 브로우 카라 증정 기획),16000,12800,999,3200,20.0,30
에이프릴스킨,에이프릴스킨 매직스노우 쿠션 블랙 3.0 (본품+리필 증정),33000,23100,999,9900,30.0,31
라네즈,[1월올영PICK/1+1] 라네즈 크림스킨 170ml 리필 기획 (+170ml 리필),33000,23700,999,9300,28.2,32
웨이크메이크,[1월한정기획] 웨이크메이크 듀이 젤 글로우 틴트 12 COLOR (립오일기획/단품),14000,11200,999,2800,20.0,33
닥터지,[2세대 천만크림] 닥터지 레드 블레미쉬 클리어 수딩 크림 70ml+30ml 세트,38000,26600,999,11400,30.0,34
롬앤,[NEW] 롬앤 글래스팅 컬러 글로스,13000,9900,441,3100,23.8,35
라로슈포제,라로슈포제 시카플라스트 밤B5+ 200ml 기획 (+시카토너 50ml+시카밤 3ml*2 증정),68000,49900,999,18100,26.6,36
페리페라,[페리복권] 페리페라 잉크 무드 글로이틴트,11000,8800,999,2200,20.0,37
셀리맥스,[100% 페이백이벤트] 셀리맥스 시카 지우개패드 60매 (토너 패드),24000,17900,869,6100,25.4,38
푸드올로지,[2023어워즈/한정기획] 콜레올로지 600mg * 30+10정 추가증정,22900,17400,999,5500,24.0,39
메디힐,[2023어워즈] 메디힐 티트리 에센셜 마스크 기획 (10매+2매),20000,10000,999,10000,50.0,40
아누아,[피지쏙] 아누아 어성초 포어 컨트롤 클렌징오일 200ml,20000,16150,999,3850,19.2,41
구달,[단독기획] 구달 청귤 비타C 잡티케어 세럼 30ml 기획 (+세럼 10ml +마스크팩 1매 증정),28000,20400,999,7600,27.1,42
웨이크메이크,[NEW 컬러 출시] 웨이크메이크 소프트 블러링 아이팔레트 14 COLOR (기획/단품),34000,23800,999,10200,30.0,43
에스쁘아,[올영픽/윈터PICK] 에스쁘아 꾸뛰르 립틴트 글레이즈 6colors,22000,17600,727,4400,20.0,44
아비브,[제이나PICK / 1월 올영픽] 아비브 부활초 비피다 세럼 퍼밍 드롭 50ml 기획 (+30ml 추가 증정),32000,22400,999,9600,30.0,45
마그랩,[1월 올영픽]마그랩 포 스트레스 글루콘산마그네슘 25ml*10+2입 단독기획 (12일분),39000,27900,999,11100,28.5,46
넘버즈인,[피부결] 넘버즈인 3번 참은만큼 보들보들 결세럼팩 1매,4000,2000,999,2000,50.0,47
글린트,[NEW] 글린트 하이라이터,22000,18700,999,3300,15.0,48
바닐라코,[2023어워즈][더블기획]바닐라코 클린잇제로 클렌징밤 오리지널 100ml(+100ml 추가 증정),34000,21900,999,12100,35.6,49
웨이크메이크,[1+1기획] 웨이크메이크 철벽 펜 아이라이너 3color (1+1기획/단품),13000,11700,999,1300,10.0,50
투쿨포스쿨,[애교살메이커]투쿨포스쿨 프로타주 펜슬,12000,9900,999,2100,17.5,51
스킨시그널,[포니 PICK] 스킨시그널 클레이 효소클렌저 3종 택1,25000,18900,999,6100,24.4,52
마르시끄,"[브라이언 PICK] 마르시끄 링클 리페어 주름패치(미간, 팔자, 이마) 3종 택 1",12900,11800,999,1100,8.5,53
에스트라,[NEW/리뉴얼] 에스트라 아토베리어365 로션 150ml,33000,26400,14,6600,20.0,54
피지오겔,[한정기획] 피지오겔 데일리뮨 앰플 세럼 20ml+4ml+마스크팩1매 증정 기획,45000,39900,999,5100,11.3,55
아비브,[1월 올영픽] 아비브 부활초 크림 뉴트리션 튜브 75ml 기획 (+30ml 추가 증정),35000,24000,999,11000,31.4,56
케어플러스,[6년연속1위]케어플러스 상처커버 스팟패치 어워즈 한정기획(102+42매),6000,5420,999,580,9.7,57
아임미미,[애교살][하리무&레디 Pick] 아임미미 아임스틱 아이섀도우 시머 애교살메이커,9900,7400,999,2500,25.3,58
아누아,[2023어워즈/3년연속] 아누아 어성초 77 수딩 토너 350ml 어워즈 한정 기획 (본품+리필팩+진정마스크1매),45000,29900,999,15100,33.6,59
메디힐,[유이수 PICK] 메디힐 비타민씨 브라이트닝 세럼 40ml,22000,14900,171,7100,32.3,60
웰라쥬,[형원PICK] 웰라쥬 리얼 히알루로닉 블루 100 앰플 75ml 1+1 기획,46000,28500,999,17500,38.0,61
클리오,[2023어워즈/4년연속 1등] 클리오 킬커버 더뉴 파운웨어 쿠션(본품+리필+쉐딩스틱 증정 기획),36000,27000,999,9000,25.0,62
낫츠,낫츠 센텔라스카 연고 일랑일랑 15g,20000,18000,999,2000,10.0,63
토니모리,[재유PICK][24SS/NEW] 토니모리 겟잇틴트 워터풀버터 13종,16000,12800,999,3200,20.0,64
달바,[22관왕/3000만병 누적판매] 달바 화이트 트러플 퍼스트 스프레이 세럼 100ml,29900,20900,999,9000,30.1,65
라보에이치,[2023 어워즈 샴푸 1위] 라보에이치 두피강화 샴푸 탈모증상완화 750ML 어워즈 한정기획(+120ML 2개),36000,26900,999,9100,25.3,66
토리든,[대용량기획] 토리든 다이브인 저분자 히알루론산 세럼 70ml 대용량 기획(+세럼 10ml),32000,24000,999,8000,25.0,67
아이디얼포맨,[5년연속1위]아이디얼 포맨 퍼펙트 올인원 밀크 어워즈 한정기획,29000,20900,999,8100,27.9,68
넘버즈인,[흔적미백] 넘버즈인 5번 비타민C 뿌려만든 글루타치온 필름팩 1매,4000,2000,255,2000,50.0,69
토리든,[2023어워즈] 토리든 다이브인 저분자 히알루론산 마스크 10매 어워즈 한정기획 (+3매+밸런스풀마스크1매),30000,18000,999,12000,40.0,70
정샘물,정샘물 에센셜 스킨 누더 쿠션 (본품+리필) 택 1,42000,39900,999,2100,5.0,71
투크,[NEW도화살몬] 투크 워터프루프 슬림 아이라이너 10colors,13900,12510,999,1390,10.0,72
클리오,[1등마스카라]클리오 킬래쉬 수퍼프루프마스카라 1+1 기획,18000,17400,999,600,3.3,73
러븀,[1월 올영픽] 러븀 애프터 글로우 유자 겔 마스크 5매,25000,16700,999,8300,33.2,74
에스쁘아,[1월 올영픽] 에스쁘아 비글로우/비벨벳 쿠션 에어퍼프 5개입(2종),10000,7900,999,2100,21.0,75
브링그린,브링그린 프레시마스크 1매 5종,1800,990,999,810,45.0,76
3CE,[NEW/민니PICK] 3CE 샤인 리플렉터,19000,17100,146,1900,10.0,77
코스알엑스,코스알엑스 약산성 나이아신아마이드 미셀라 클렌징 워터 400mL,17000,9520,999,7480,44.0,78
롬앤,[NEW/립밤] 롬앤 글래스팅 멜팅 밤,13000,9900,999,3100,23.8,79
넘버즈인,[모공각질] 넘버즈인 4번 모공제로 깐달걀 토너패드 70매 기획 (+10매 추가 증정),26000,18200,999,7800,30.0,80
넘버즈인,[흔적미백] 넘버즈인 5번 글루타치온C 흔적 앰플 30ml 기획(+패드 6매 증정),28000,19600,999,8400,30.0,81
에스트라,에스트라 에이시카365 흔적진정세럼 40ml 기획 (+크림10ml+토너25ml 증정)(2307),38000,30400,999,7600,20.0,82
리쥬란,[단독기획] 리쥬란 힐러 턴오버 앰플 듀얼 이펙트 30ml+7ml 증정 기획,59000,38300,999,20700,35.1,83
딜라이트 프로젝트,딜라이트 프로젝트 베이글칩 125g 어워즈 한정 기획 2종 (갈릭/허니),5600,3200,999,2400,42.9,84
에뛰드,[조효진 개발/NEW] 에뛰드 재창조 메이커 쉐딩 멀티 스틱 (웜&쿨),14000,11200,999,2800,20.0,85
러븀,러븀 카밍 리페어 어린시카 스팟 패드 60매,23000,15400,216,7600,33.0,86
닥터지,[나도PICK/100ml+100ml] 닥터지 더모이스처 배리어 D 인텐스 크림 100ml+100ml 듀오기획,45000,26910,999,18090,40.2,87
일리윤,일리윤 세라마이드 아토 로션기획(600ML+600ML),55900,35900,999,20000,35.8,88
스킨푸드,[한정기획/1+1] 스킨푸드 로열허니 프로폴리스 인리치 에센스 50ml 리필기획,32000,19500,999,12500,39.1,89
도브,[NEW] 도브 바디 스크럽 4종 택1,17900,13400,225,4500,25.1,90
메디힐,"[2023어워즈] 메디힐 마데카소사이드 흔적패드 100매 어워즈 기획 (+100매, 마스크2매)",39900,28900,999,11000,27.6,91
라보에이치,[1월 올영픽] 라보에이치 두피강화 캡슐트리트먼트 탈모증상완화 200ML 더블기획,28000,16900,999,11100,39.6,92
바닐라코,[2023어워즈] 바닐라코 프라임 프라이머 피니쉬 파우더 12g 어워즈 한정기획(+프라이머 15ml증정),22000,17600,999,4400,20.0,93
토르홉,토르홉 사우난지앙 솔트 마스크 150g,45100,38400,877,6700,14.9,94
메디힐,[단독기획] 메디힐 콜라겐 에센셜 마스크 10+1매 기획,20000,10000,999,10000,50.0,95
일리윤,[1월 올영픽] 일리윤 세라마이드 아토 로션 (본품600ML+128ML 증정),33900,21900,999,12000,35.4,96
어노브,어노브 실크 오일 에센스 70ml (단백질 헤어 에센스),19000,16900,999,2100,11.1,97
아리얼,[ 1월 올영픽] 아리얼 더 퍼펙트 클렌징 티슈 플러스 100매,9900,5700,999,4200,42.4,98
메디필,[1월올영픽] 메디필 레드 락토 콜라겐 클리어 폼 2.0 기획 (300ml+딥 해면 구성),24000,12500,999,11500,47.9,99
롬앤,[블러셔] 롬앤 베러 댄 치크,12000,9900,999,2100,17.5,100
듀이셀,듀이셀 큐라톤즈 모이스쳐 40ml,23900,19100,6,4800,20.1,101
클리오,클리오 벨벳립펜슬 샤프너 증정 기획세트,14000,9310,999,4690,33.5,102
바이오더마,[2023어워즈] 바이오더마 센시비오 H2O 500ml 더블 어워즈 한정기획(10ml+화장솜 증정),42000,31900,999,10100,24.0,103
파넬,[단독 기획] 파넬 시카마누 92세럼 더블 기획,52000,44200,999,7800,15.0,104
메디필,메디필 히알루론산 레이어 물톡스 앰플 더블 기획 30ml,34000,25500,999,8500,25.0,105
웨이크메이크,[1월올영픽] 웨이크메이크 워터 글로우 코팅 쿠션 (리필기획/스트랩기획),36000,26800,999,9200,25.6,106
투쿨포스쿨,[6년연속수상쉐딩] 투쿨포스쿨 바이로댕 쉐이딩 단품/기획(+미니쉐딩증정),16000,14400,999,1600,10.0,107
딥트3일,[1월 올영픽]딥트 3일 피치맛번 x 숌 포니 피치 뷰티 콜라보 기획 (30일분),49000,36700,999,12300,25.1,108
모레모,[1월 올영픽]모레모 헤어 트리트먼트 미라클 2X 베이커리 에디션 기획 480ml(60ml 증정),39000,22900,999,16100,41.3,109
포맨트,포맨트 시그니처 퍼퓸 50ml (코튼메모리),49000,46000,999,3000,6.1,110
VDL,"[리뷰이벤트] VDL 커버스테인 퍼펙팅 파운데이션 30ml (SPF35, PA++)",30000,24000,999,6000,20.0,111
닥터자르트,닥터자르트 세라마이딘 울트라 모이스처라이징 크림 50ml,50000,25000,999,25000,50.0,112
에스쁘아,[올영픽/윈터PICK] 에스쁘아 비글로우 뉴클래스 쿠션 단독기획 (본품+리필+체리퍼프+비글로우 파운데이션 7ml),38000,29900,999,8100,21.3,113
얼터너티브스테레오,[NEW] 얼터너티브스테레오 립 포션 바미 로즈,19000,17100,304,1900,10.0,114
토리든,[단독기획] 토리든 다이브인 저분자 히알루론산 수딩 크림 100ml 기획(+20ml),24000,16800,999,7200,30.0,115
클리오,[NEW 컬러 추가] 클리오 프로아이팔레트에어 기획/단품,34000,23800,999,10200,30.0,116
어노브,어노브 히팅 가드 노워시 트리트먼트 147ml (극손상모 헤어팩),18000,14900,999,3100,17.2,117
비플레인,비플레인 녹두 약산성 클렌징폼 160ml + 40ml 기획,21900,18600,999,3300,15.1,118
달바,[선물추천] 달바 시그니처 오리지널 & 프리미엄 비건 미스트 세럼 기프트 세트,55000,35900,537,19100,34.7,119
토리든,[단독기획] 토리든 다이브인 저분자 히알루론산 클렌징 폼 더블 기획 (150ml+150ml),26000,18200,999,7800,30.0,120
그로우어스,[2023어워즈] 그로우어스 데미지 테라피 노워시 트리트먼트 250ml 어워즈 한정기획(+샴푸 100ml),26000,23200,999,2800,10.8,121
파파레서피,"파파레서피 효소 파우더 클렌저 50g 3종 택1 ([인씨 PICK] 블레미쉬(광채), 가지(보습), 티트리(진정))",18000,13680,999,4320,24.0,122
아벤느,[올리버쌤PICK]아벤느 오 떼르말 300ml 더블 한정기획 (와다다곰 콜라보),34000,21700,999,12300,36.2,123
디마르3,[Y자모공교정/리뷰이벤트] 디마르3 시그니처 에스투드 프로텍터 대용량 앰플 170ml,59900,55200,999,4700,7.8,124
더샘,[1등 컨실러] 더샘 커버 퍼펙션 트리플 팟 컨실러 4colors,12000,11400,999,600,5.0,125
폰즈,[1월 올영픽 / 오일증정] 폰즈 클리어 스파 립앤아이 리무버 300ml 기획세트,24500,12500,999,12000,49.0,126
아비브,[2023어워즈] 아비브 어성초 스팟 패드 카밍터치 80매 더블 기획,42000,24000,999,18000,42.9,127
메디힐,메디힐 티트리 에센셜 마스크 1매,2000,1000,999,1000,50.0,128
넘버즈인,[피지진정] 넘버즈인 1번 시카 갈아만든 초록패드 70매 기획 (+10매 추가 증정),26000,18200,999,7800,30.0,129
좋은느낌,좋은느낌 입는오버나이트 4P 1+1 한정 기획(총 8P) 2종 중 택1 (중형/대형),8600,6200,999,2400,27.9,130
아누아,[리필기획] 아누아 어성초 77 클리어패드 리필 기획 (70+70매 리필),45000,33700,999,11300,25.1,131
AHC,[판매량 1억개 돌파] AHC 텐 레볼루션 리얼 아이크림 포 페이스 스페셜 퍼밍 세트,23000,16900,999,6100,26.5,132
레이비,레이비 바디워시 500ml 4종 택1,10900,8900,999,2000,18.3,133
데이지크,[NEW] 데이지크 멜팅 캔디 밤 5종 택1,14000,9980,999,4020,28.7,134
피지오겔,[한정기획] 피지오겔 레드수딩 AI 크림 100ml+30ml 증정 기획,49900,29900,999,20000,40.1,135
아이오페,[단독기획] 아이오페 레티놀 슈퍼 바운스 세럼 30ml 기획(+세럼 10ml+바이오에센스48ml),50000,42000,999,8000,16.0,136
세타필,세타필 모이스춰라이징 로션 1L,25600,20900,999,4700,18.4,137
아비브,[NEW] 아비브 껌딱지 시트 마스크 마데카소사이드 스티커 1매,4000,2000,999,2000,50.0,138
더마토리,더마토리 프로 비타 에이 레티날덤 밴드 마스크 1매 (모공탄력),4000,2000,999,2000,50.0,139
닥터지,닥터지 브라이트닝 필링젤 120g 기획 (필링젤 60g+배리어D로션 2ml),21000,17850,999,3150,15.0,140
아리얼,[ 1월 올영픽] 아리얼 스트레스 릴리빙 립앤아이 리무버 패드 30매,3900,2800,999,1100,28.2,141
3CE,[2023어워즈/한정기획] 3CE 블러 매트 립스틱(단품/기획),22000,16500,999,5500,25.0,142
메디힐,[단독기획] 메디힐 마데카소사이드 에센셜 마스크 10+1매 기획,20000,10000,999,10000,50.0,143
에뛰드,[올영단독] 에뛰드 진저 슈가 립케어 3종 택1 (립마스크/립밤/스틱),7000,6300,999,700,10.0,144
트리헛,[7년연속 1위][규진 PICK] 트리헛 시어 슈가 스크럽 510g 12종 택1 (단품/기획),22500,18000,999,4500,20.0,145
브링그린,[백현 PICK] 브링그린 티트리시카수딩크림플러스 100mL더블기획_NEW,34200,20520,999,13680,40.0,146
테라브레스,테라브레스 오랄린스 패밀리사이즈 1L+150ml 기획 (12ml*5ea 증정) 중 택1,22900,20100,999,2800,12.2,147
메디힐,메디힐 워터마이드 에센셜 마스크 1매,2000,1000,999,1000,50.0,148
라이브오랄스,라이브오랄스 퓨어다이아 치아미백제 (2주분),32500,29100,361,3400,10.5,149
그린몬스터,[1월 올영픽] 그린몬스터 데일리 헐리우드48시간 원조 비건 클렌즈,3800,3100,999,700,18.4,150
크리니크,[2023 어워즈] 크리니크 치크 팝 단품 택1 (발레리나팝 외),36000,30600,999,5400,15.0,151
일소,[로운PICK]일소 네추럴 마일드 클리어 노우즈 팩 5매입,12900,11900,999,1000,7.8,152
피지오겔,[한정기획] 피지오겔 DMT 페이셜 로션 200ml+50ml 증정 기획,38000,21500,999,16500,43.4,153
더하르나이,[혜림쌤 PICK][단독기획]더하르나이 시카이드 크림 100ml + 30ml 기획,29000,23200,186,5800,20.0,154
메디힐,[NEW]메디힐 레티놀 콜라겐 아이 앰플 패치 60매,23000,13900,662,9100,39.6,155
롬앤,[섀도우] 롬앤 베러 댄 팔레트 (단품/기획),30000,22900,999,7100,23.7,156
덴티스테,덴티스테 후레쉬 브레스 스프레이 15ml,8900,7100,999,1800,20.2,157
코스알엑스,코스알엑스 클리어 핏 마스터 패치 18매,3500,2100,99,1400,40.0,158
아로마티카,아로마티카 퓨어 앤 소프트 여성청결제 듀오 2종 택 1 (170ml 기획 / 200ml 기획),35000,21000,999,14000,40.0,159
라씨엘르,[단독증량기획] 라씨엘르 엔자임 곡물 클렌징 파우더워시 기획 (본품60g + 10g 추가 증정),24000,16800,999,7200,30.0,160
바른생각,[의료기기] 바른생각 콘돔 8종 택 1 (초박형/에어핏/워터리/라지핏/슬림핏/퍼펙트핏/대용량/슬림핏),13900,10900,999,3000,21.6,161
파티온,[단독기획] 파티온 노스카나인 트러블 흔적 앰플 30ml 한정기획(+트러블세럼 30ml & 흔적크림 1ml*3),48000,38400,999,9600,20.0,162
에스트라,에스트라 아토베리어365 하이드로 수딩크림 60ml,33000,26400,999,6600,20.0,163
바이탈뷰티,[1월 올영픽][민스코PICK/30+10포]바이탈뷰티 슈퍼레티놀C 기획세트,28000,22400,999,5600,20.0,164
아임미미,[쉐딩스틱][하리무&레디 Pick]아임미미 아임멀티스틱 쉐딩 하이라이터 블러셔),12000,9000,999,3000,25.0,165
좋은느낌,좋은느낌 좋은순면 생리대 4종 택 1 (중형 / 대형 / 수퍼롱 / 라이너),6000,3300,999,2700,45.0,166
듀이트리,[더보이즈큐포카&다꾸템증정]AC 컨트롤 딥 그린 카밍 에센스 기획(40ml+크림20ml),28000,17600,999,10400,37.1,167
피카소,피카소 메이크업 스파츌라 어워즈 한정기획(+클라우드 퍼프2P+헤어핀2P),19000,14160,999,4840,25.5,168
비건이펙트,비건이펙트 클린 앤 글로우 청보리 LHA 젤 클렌저 205ml 기획 (+토너패드 4EA 증정),22000,20000,441,2000,9.1,169
포맨트,[1등 향수] 시그니처 퍼퓸 50ml 코튼허그 어워즈 한정기획 (본품+휴대용 향수 9ml),39000,37000,999,2000,5.1,170
데이지크,[NEW컬러] 데이지크 쥬시 듀이 틴트 19종 택 1,17000,11900,999,5100,30.0,171
라엘,라엘 유기농순면커버 생리대 6종 택1,7900,6900,999,1000,12.7,172
푸드올로지,[서현pick]콜레올로지 버닝올로지 디데이 3.8g*5포 (5일분),18900,15600,999,3300,17.5,173
라운드랩,[단독대용량] 라운드랩 자작나무 수분 크림 120ml 기획 (+수분패드 4매),42000,27300,999,14700,35.0,174
에스쁘아,[1월 올영픽] 에스쁘아 프로테일러 파운데이션 비글로우 뉴클래스 30g,40000,29900,999,10100,25.2,175
러븀,러븀 슬로우 에이징 피토 콜라겐 겔 마스크 5매입,25000,16700,728,8300,33.2,176
필리밀리,필리밀리S 브러시 7종 택1,35000,27120,999,7880,22.5,177
에스쁘아,[2023어워즈]에스쁘아 비벨벳 커버쿠션 뉴클래스 어워즈 기획(본품+리필+비벨벳 파데 7ml *2 추가증정),38000,32300,999,5700,15.0,178
라로슈포제,라로슈포제 시카플라스트 크림 B5 100ml 기획 (+시카마스크 25g),58000,39900,509,18100,31.2,179
컬러그램,[NEW COLOR] 컬러그램 음영 창조 라이너 4종,9900,7900,999,2000,20.2,180
루나,[올리브영 5년연속 1위] 루나 롱래스팅 팁 컨실러 7.5g 7colors,15000,11200,999,3800,25.3,181
조선미녀,조선미녀 맑은쌀선크림 더블기획세트 50ml*2,30000,24000,679,6000,20.0,182
라로슈포제,라로슈포제 똘러리앙 포밍클렌저125ml 더블 기획 (+똘러리앙로션 15ml),56000,39200,999,16800,30.0,183
필리밀리,[대용량]필리밀리 1/2 화장솜 320P,9900,8900,999,1000,10.1,184
넘버즈인,[쿨링진정] 넘버즈인 4번 SOS 응급진정 얼음장팩 1매,4000,2000,999,2000,50.0,185
어노브,[2023 어워즈 헤어케어 1위]어노브 딥 데미지 트리트먼트 EX (본품207ml+100ml 추가 증정),22000,17010,999,4990,22.7,186
토리든,[단독기획] 토리든 다이브인 저분자 히알루론산 토너 300ml 기획(+100ml 추가 증정),21000,15700,999,5300,25.2,187
미쟝센,[2023 어워즈 헤어염색 1위] 블랙핑크x미쟝센 헬로크림 단품 및 한정기획,16000,8800,999,7200,45.0,188
라네즈,라네즈 네오 쿠션 매트 15g 기획/단품,30000,25500,999,4500,15.0,189
이니스프리,이니스프리 레티놀 시카 흔적 앰플 30ml 기획 (+7ml),40000,28000,999,12000,30.0,190
아크로패스,아크로패스 트러블큐어 18매 기획(다크스팟케어 6매 증정),25900,23300,184,2600,10.0,191
웨이크메이크,[1월한정기획] 웨이크메이크 듀이 젤 글레이즈 스틱 12 COLOR (립펜슬기획/단품),16000,12800,999,3200,20.0,192
노베브,[NEW뮤트컬러출시][재유 공동개발] 애교살메이커 노베브 언더 아이 마스터,17000,16150,999,850,5.0,193
코스노리,[2023어워즈] 코스노리 화이트닝 드레스 비건 톤업크림 어워즈 한정기획 (톤업크림 쿠션 증정),20000,16000,999,4000,20.0,194
더샘,[대용량 단독기획] 더샘 커버 퍼펙션 팁컨실러 9.5g 6colors,7700,6930,999,770,10.0,195
아비브,[증량] 아비브 아크네 폼 클렌저 어성초 폼 대용량 250ml,21000,15900,999,5100,24.3,196
셀퓨전씨,[베스트/밀착차단] 셀퓨전씨 레이저 썬스크린 더블기획 (35ml+35ml),29400,26400,999,3000,10.2,197
스너글,스너글 섬유탈취제 470ml 6종 택1,8500,5700,999,2800,32.9,198
테일러,테일러 푸룬 농축 딥워터 180ml,4500,4050,999,450,10.0,199
필리밀리,필리밀리 아이메이크업 브러시세트 (5종),15500,13200,999,2300,14.8,200
토리든,[1월 올영픽/올영단독] 토리든 셀메이징 저분자 콜라겐 탄력 겔마스크 (얼굴 집중케어) 1매,6000,3600,149,2400,40.0,201
메이크프렘,메이크프렘 저자극 순둥 클렌징 밀크 기획 (200ml+폼50ml),24000,18000,999,6000,25.0,202
에스쁘아,[올영픽/윈터PICK] 에스쁘아 리얼아이팔레트 올뉴 4 colors,34000,25500,546,8500,25.0,203
키스미,[NEW 컬러출시] N0.1 키스미 스무스 리퀴드 아이라이너 N,18000,12600,999,5400,30.0,204
오브제,[덱스 PICK] 오브제 내추럴 커버 파운데이션 기획세트(+클렌징폼 50ml),36800,30900,999,5900,16.0,205
아임미미,[쉐딩스틱][하리무&레디 Pick]입체음영창조 아임미미 아임멀티스틱듀얼 쉐딩&하이라이터 컨투어링(웜/쿨)(+퍼프증정),16000,11400,999,4600,28.7,206
티타드,티타드 프레시 브레스 플러스 치약 더블기획 (100g*2 + 50g 증정),22000,18700,999,3300,15.0,207
유리아쥬,유리아쥬 스틱레브르 오리지널 보습 립밤 더블기획 (4g +4g),20000,17000,999,3000,15.0,208
넘버즈인,[피지순삭] 넘버즈인 1번 말끔 순삭 클렌징 오일 400ml 대용량 기획,35000,24500,999,10500,30.0,209
플라이밀,플라이밀 단백질쉐이크 45g 4종 택1,3900,3300,999,600,15.4,210
히말라야,히말라야 숙취해소 파티스마트 츄 10P,15000,12000,999,3000,20.0,211
라네즈,라네즈 립 슬리핑 마스크 EX 20g,22000,15400,999,6600,30.0,212
이즈앤트리,[디렉터파이추천] 이즈앤트리 어니언 뉴페어 겔크림 50ml 기획(+겔크림 20ml),32000,19900,999,12100,37.8,213
셀리맥스,[단독기획] 셀리맥스 더 리얼 노니 에너지 앰플 40ml 더블 기획 (40ml*2ea),33000,29700,999,3300,10.0,214
정샘물,정샘물 에센셜 물크림 30ml/50ml 택1 (오리지널/라이트),35000,33250,793,1750,5.0,215
닥터지,[베스트/보송톤업] 닥터지 브라이트닝 업 선 플러스 40ml+40ml,40000,29600,999,10400,26.0,216
에뛰드,[디렉터파이개발]에뛰드 순정 디렉터 수분 선크림 1+1기획(50ml+50ml),25000,23900,999,1100,4.4,217
식물나라,식물나라 제주 탄산수 모공 딥 클렌징폼150mLX2,12800,10800,999,2000,15.6,218
포맨트,포맨트 올인원 퍼퓸샤워 500ml (코튼허그),24000,21600,883,2400,10.0,219
코스노리,코스노리 롱 액티브 아이래쉬 세럼 비건 속눈썹영양제 단품/기획,16000,13600,999,2400,15.0,220
더랩바이블랑두,[리뉴업] 더랩바이블랑두 저분자 히알루론산 딥 토너 200ml + 50ml 기획,23000,15990,867,7010,30.5,221
컬러그램,컬러그램 올인원 오버립 메이커 5 COLORS,9800,8800,999,1000,10.2,222
바닐라코,[단독기획]바닐라코 클린잇제로 포어 클래리파잉 폼 클렌저 150ml 1+1기획,16000,11200,999,4800,30.0,223
3CE,[민니PICK] 3CE 무드레시피 페이스 블러쉬,18000,14400,999,3600,20.0,224
에스네이처,[인보라PICK/화해1위] 에스네이처 아쿠아 스쿠알란 세럼 50ml 기획(+50ml 리필+수분크림10ml),35000,22900,999,12100,34.6,225
비비랩,[1월 올영픽][2023어워즈/한정기획] [이효리 PICK]비비랩 저분자콜라겐S 30포 더블기획+10포 미니 증정,39800,35800,999,4000,10.1,226
달바,[19관왕] 달바 워터풀 에센스 선크림 듀오 기획 (50ml+50ml),51000,35700,999,15300,30.0,227
테일러,NEW 테일러 푸룬 딥워터 180ml 매실/콤부차/커피 3종 택1,4500,3150,999,1350,30.0,228
젬소,[리뉴얼]젬소 아이래쉬 앤 아이브로우 멀티액티브 세럼 3ml+1ml 증정기획,43800,40700,432,3100,7.1,229
파티온,[단독기획] 파티온 노스카나인 트러블 흔적 리페어 크림 50ml 기획(+5ml+흔적앰플 1ml*3ea),35000,28000,769,7000,20.0,230
웨이크메이크,[리뉴얼/듀얼브로우] 웨이크메이크 파우더 젯 듀얼 브로우 5 COLOR,12000,9120,999,2880,24.0,231
네이처메이드,"네이처메이드 칼슘,마그네슘,아연,비타민D 180정 (2개월분)",25000,20000,999,5000,20.0,232
어뮤즈,[2023어워즈] 어뮤즈 듀 젤리 비건 쿠션(본품+리필+젤핏틴트 미니 06 서울 걸),34000,30600,999,3400,10.0,233
네이밍,[단독기획] 네이밍 레이어드 핏 쿠션 기획 (본품+리필),34000,30600,999,3400,10.0,234
아비브,[1월 올영픽] 아비브 콜라겐 아이패치 부활초 젤리 60매,23000,14950,999,8050,35.0,235
더마비,[단독/대용량] 더마비 데일리 모이스처 바디로션 860ml,23000,19800,999,3200,13.9,236
로레알,[한소희Pick]로레알파리 헤어오일 100ml 9종,22000,14900,999,7100,32.3,237
이지엔,NEW) 이지엔 푸딩 헤어컬러 19종 택1 (염색),16000,8800,999,7200,45.0,238
일소,[로운PICK]일소 네추럴 마일드 클리어 노우즈 팩 10매 기획,25000,21500,999,3500,14.0,239
모로칸오일,모로칸오일 헤어 트리트먼트 100ml(펌프포함) 택1 (오리지널/라이트),58000,52200,9,5800,10.0,240
토리든,토리든 밸런스풀 시카 마스크 1매,3000,1500,999,1500,50.0,241
구달,[단독기획] 구달 청귤 비타C 잡티케어 패드 70매 (+10매 증정기획),26000,17290,898,8710,33.5,242
미쟝센,미쟝센 쉽고 빠른 거품염색 (염색+새치겸용),16000,9900,999,6100,38.1,243
라로슈포제,라로슈포제 NEW 시카플라스트 밤B5+ 100ml 기획(+시카밤 3ml * 2 증정),39000,33150,999,5850,15.0,244
메디필,[민카롱 PICK] 메디필 엑스트라 슈퍼9 플러스 2.0 기획 (피지연화제),24900,14160,999,10740,43.1,245
빼바,[성해은PICK/노슈가 프로틴바] 빼바 리얼초콜릿 프로틴바 40g 2종 택1 (다크/화이트),2700,2300,999,400,14.8,246
푸드올로지,[2023어워즈/한정기획] 콜레올로지 컷팅 젤리 10포+4포 증정기획,23900,18800,999,5100,21.3,247
하아르,[1월올영픽/탈모증상완화] 하아르 닥터란 계란유래단백질 샴푸 500ml,29800,25800,169,4000,13.4,248
스너글,스너글 섬유탈취제 150ml 6종 택1,5000,3300,999,1700,34.0,249
바이오힐보,바이오힐보 프로바이오덤 99.9 멜팅 콜라겐 아이필름 10매 대용량 (+콜라겐세럼 7ml*2 증정기획),36800,22950,553,13850,37.6,250
그라펜,[태이PICK] 그라펜 에어커버 스틱 파운데이션 13g 기획 (+트리플 핸섬립밤 4.3g) 2종 택1,31000,28800,47,2200,7.1,251
덴티스테,덴티스테 뉴플러스화이트 치약 튜브 160g 4개입/12개입 2종 택 1,62320,37300,999,25020,40.1,252
퓌,퓌 블러셔 멜로우 8color,19000,11400,999,7600,40.0,253
보로탈코,[1월 올영픽] 보로탈코 크레마 벨루탄테 크림 3종 택 1(30ml/30ml 더블기획/150ml),7500,5500,999,2000,26.7,254
웨이크메이크,[1월한정기획] 웨이크메이크 믹스 블러링 볼륨 쉐딩 2COLOR (쉐딩스틱기획/단품),16000,13600,999,2400,15.0,255
사포렐,사포렐 여성청결제 2종 택1 (폼타입/젤타입),15900,14900,999,1000,6.3,256
네이처메이드,네이처메이드 액티브 데일리 멀티 포 우먼 120정 (2개월분),35000,28000,999,7000,20.0,257
넘버즈인,[피지진정]넘버즈인 1번 진정 맑게담은 청초토너 300ml 리필기획(+300ml 증정),40000,28000,999,12000,30.0,258
그라펜,[올영픽/태이PICK] 그라펜 제주 해수 볼륨업 컬크림 180ml 1+1 기획,15000,13300,425,1700,11.3,259
더단백,빙그레 더단백 팝칩 군옥수수,2500,1800,999,700,28.0,260
비플레인,[단독기획] 비플레인 녹두 클렌징 오일 200ml + 50ml 세트,24000,21600,999,2400,10.0,261
아이소이,"[한정기획] 아이소이 11년간, 1등 잡티세럼 20ml+20ml+15ml 증량 기획",54000,41040,999,12960,24.0,262
비브리브,"비브리브 꼬박꼬밥 5종 중 택1(미숫가루,초코,스윗콘,밤,흑임자)",3900,3500,999,400,10.3,263
웨이크메이크,[1+1기획] 웨이크메이크 내추럴 하드 브로우 펜슬 1+1 기획/단품,13000,11700,999,1300,10.0,264
메디필,[1월올영픽] 메디필 레드 락토 콜라겐 클렌징 오일 2.0 200ml 기획 (+15ml 추가증정 ),21000,15500,999,5500,26.2,265
클리오,클리오 킬브로우 오토하드브로우펜슬,20000,14000,999,6000,30.0,266
정샘물,정샘물 에센셜 스킨 누더 롱웨어 쿠션 (본품+리필),42000,39900,999,2100,5.0,267
라운드랩,라운드랩 소나무 진정 시카 앰플 30ml+30ml 더블기획,43000,30000,999,13000,30.2,268
에스트라,에스트라 더마UV365 장벽수분 무기자차 선크림 40ml+10ml 기획 (+크림10ml 증정)(2307),31000,18600,999,12400,40.0,269
닥터지,[대용량] 닥터지 더모이스처 배리어 D 로션 300ml 기획 (+멀티밤 1g),37000,25900,999,11100,30.0,270
라보에이치,[1월 올영픽] 라보에이치 두피강화샴푸 탈모증상완화 333ML 기획(+333ML 리필),33900,22900,999,11000,32.4,271
달리프,[1등 헤어토닉]달리프 클로렐라 헤어토닉 더블 기획(100ml+100ml)(탈모증상완화),21000,16400,999,4600,21.9,272
케어플러스,[6년연속1위]케어플러스 상처커버 스팟패치 102매,6000,5420,999,580,9.7,273
하아르,[1월올영픽/단독기획] 하아르 닥터모리엔 탈모토닉 100ml 기획 (+샴푸 75ml 증정),34900,25800,686,9100,26.1,274
아비브,[1월 올영픽] 아비브 콜라겐 아이크림 부활초 튜브 30ml 기획 (+부활초 크림 30ml 증정),26000,18200,247,7800,30.0,275
존슨즈,[하니얌Pick] 존슨즈베이비 베드타임 로션 500ml,20900,11900,999,9000,43.1,276
넘버즈인,[탄력미백] 넘버즈인 2번 워터콜라겐 65% 볼륨팩 기획 4매 (+1매 증정기획),16000,8000,999,8000,50.0,277
넘버즈인,[수분광채] 넘버즈인 1번 수분흠뻑 스파광 삼림욕팩 4매 (+1매 증정기획),16000,8000,999,8000,50.0,278
트리셀,[1+1기획]트리셀 데이/나이트 콜라겐 샴푸 더블 기획(360ml+360ml) 2종 택 1,36000,18000,999,18000,50.0,279
필리밀리,필리밀리 엠보싱화장솜 600P,9800,7900,999,1900,19.4,280
바이오힐보,[NEW]바이오힐보 판테셀 리페어시카 거즈패드 80매+80매 기획,44800,28800,999,16000,35.7,281
샤이샤이샤이,샤이샤이샤이 바나나 컨실 아이크림 15g,26000,17820,999,8180,31.5,282
라보에이치,[1월 올영픽] 라보에이치 두피강화 앰플토닉 탈모증상완화 100ML(두피집중영양),24000,15900,635,8100,33.8,283
토리든,[1월 올영픽/대용량기획] 토리든 다이브인 저분자 히알루론산 토너 500ml 기획 (+화장솜 60매 증정),29000,19800,999,9200,31.7,284
센카,[온라인 단독기획] 센카 퍼펙트 휩 페이셜 워시  120g* 3입 세트,25800,19800,999,6000,23.3,285
박준뷰티랩,[대용량] 박준뷰티랩 LPP 단백질 헤어팩 트리트먼트 1000ml 2종 택1 (로맨틱 딜라이트/화이트머스크),17600,15800,999,1800,10.2,286
라보에이치,[올영단독/대용량] 라보에이치 두피강화샴푸 탈모증상완화 750ML 리필 기획 (+600ML 리필),57900,37800,999,20100,34.7,287
토리든,[1월 올영픽/단독기획] 토리든 셀메이징 저분자 콜라겐 탄력 크림 60ml 기획 (+탄력 크림 2ml*5ea),30000,19500,157,10500,35.0,288
유기농본,유기농본 울트라슬림날개 대형 28입/중형30입 2종 택 1,11600,8400,999,3200,27.6,289
웨이크메이크,[1월올영픽][1+1기획] 웨이크메이크 스트롱 볼륨 래쉬 앰플 (단품/기획),14000,12600,999,1400,10.0,290
코스알엑스,[단독 90매 대용량] 코스알엑스 원스텝 패드 90매 3종 중 택1,19000,13900,999,5100,26.8,291
락토핏,[1월 올영픽]락토핏 골드 30포 (1개월분),11900,7500,999,4400,37.0,292
페리페라,[힙행열차] 페리페라 워터베어틴트,12000,9120,999,2880,24.0,293
앰플엔,[더보이즈 현재PICK]앰플엔 세라마이드샷 보습장벽앰플 100ml기획(+10ml),18900,15200,999,3700,19.6,294
토리든,[단독기획] 토리든 다이브인 저분자 히알루론산 마스크 5+1매 기획,15000,9000,999,6000,40.0,295
페리페라,페리페라 스피디 아이브로우 오토 펜슬,4000,3200,999,800,20.0,296
카이,"KAI 휴대용뷰러(핑크,실리콘타입)",10500,9900,999,600,5.7,297
하트퍼센트,[New Color] 하트퍼센트 도트 온 무드 듀이 멜팅 립스틱 1.5g 6종 택1,15000,13500,999,1500,10.0,298
미쟝센,[염색약1위] [블랙핑크PICK] 미쟝센 헬로버블 13컬러 및 더블기획 2종,16000,8800,999,7200,45.0,299
려,[1월올영픽/고윤정PICK] 려 루트젠 여성맞춤 탈모전문케어 샴푸/샴푸기획 2종 택1,17900,14900,999,3000,16.8,300
케어플러스,케어플러스 살리실산 트러블 패치 12매,9800,7900,697,1900,19.4,301
폰즈,폰즈 클리어 스파 립앤아이 리무버 (본품300ml+120ml),32900,18100,999,14800,45.0,302
린제이,린제이 프리미엄 쿨티트리 모델링 팩 1Kg,20000,18000,999,2000,10.0,303
딜라이트 프로젝트,[선물추천] 딜라이트 프로젝트 베이글칩 5종 컬렉션,13000,8900,999,4100,31.5,304
리쥬란,[피부특화 DNA성분] 리쥬란 힐러 턴오버 액티브 크림 50ml 기획(+더마힐러 크림 10g 증정),49000,19600,888,29400,60.0,305
닥터지,[단독기획] 닥터지 레드 블레미쉬 클리어 모이스처 크림 70ml+30ml 기획,39000,29250,718,9750,25.0,306
쏘피,"쏘피 바디피트 볼록맞춤 4종 택 1 (중형16P, 대형16P, 슈퍼롱10P, 오버나이트12P)",6600,3300,999,3300,50.0,307
페리페라,[페리복권] 페리페라 하트잼 글로우 립,11000,8800,311,2200,20.0,308
라엘,라엘 유기농 순면커버 입는오버나이트 4P 2종 택1 (M/L),7400,5500,999,1900,25.7,309
려,[1월 올영픽] 려 루트젠 탈모증상전문케어 두피에센스 80ML 더블기획,39800,21900,402,17900,45.0,310
키스미,[파우치증정] 키스미 스무스 리퀴드 라이너 슈퍼 킵,18000,13500,999,4500,25.0,311
라운드랩,라운드랩 1025 독도 토너 (본품200ml+50ml 추가 증정),15000,13500,999,1500,10.0,312
애프터블로우,[NEW]애프터블로우 솔리드 퍼퓸 4종 택1,36000,28800,39,7200,20.0,313
에스티로더,에스티 로더 갈색병 세럼 기획 (본품30ml+7mlx3개 기획),124000,105400,999,18600,15.0,314
지베르니,[NEW기획세트 출시] 지베르니 밀착 커버 쿠션 (본품+리필/미니컨실러기획),37000,33300,999,3700,10.0,315
바닐라코,[정한 PICK]바닐라코 클린잇제로 클렌징밤 포어클래리파잉 100ml,20000,13300,999,6700,33.5,316
라이블링,"[1월 올영픽]라이블링 클렌즈, 그린케어 15ml*10포입 2종 택 1 (레몬맛/청사과맛)",11900,8460,473,3440,28.9,317
넘버즈인,[탄력광채] 넘버즈인 3번 결광가득 에센스 토너 300ml 대용량 기획,32000,24000,999,8000,25.0,318
스카이보틀,[1월 올영픽] 스카이보틀 퍼퓸 핸드크림 50ml 5종 택1,12000,7900,999,4100,34.2,319
바닐라코,[NEW] 바닐라코 스머징 립 펜슬 0.8g / 5colors,14000,11200,999,2800,20.0,320
노베브,[NEW컬러][재유 공동개발] 노베브 슬림 엣지 듀얼 아이라이너 5colors,19000,18050,999,950,5.0,321
코피코,마요라 코피코 커피맛캔디 블리스터 32g,1000,800,999,200,20.0,322
드림웍스,드림웍스 아임더 리얼 슈렉팩 110g,12600,9900,999,2700,21.4,323
라부르켓,[김우석PICK] [3만원이상 구매시 추가증정] 라부르켓 립밤 아몬드코코넛 14g,22000,17900,42,4100,18.6,324
바렌,바렌 발각질지우개 (미스트+풋파일),14900,13900,999,1000,6.7,325
브이앤에이뷰티,[2023어워즈/100ml한정기획] V&A 미백광채앰플 (50ml+50ml 리필),58000,37050,999,20950,36.1,326
뉴칸,뉴칸 더블파워 밀크씨슬+멀티비타민 30개입 (30일분),128000,99000,25,29000,22.7,327
온더바디,[마루는강쥐X온더바디] 온더바디 코튼풋 발가글하자 풋미스트 100ml,11900,5950,18,5950,50.0,328
라운드어라운드,[2023어워즈] 라운드어라운드 그린티 약산성 클렌징폼 200ml 더블 어워즈 한정기획,27000,17500,999,9500,35.2,329
모레모,[1월 올영픽]모레모 리커버리밤B 120ml 클로버 에디션 기획(40ml 증정),21000,13600,999,7400,35.2,330
grn+,[1월 올영픽]grn+ 벨리곰X슬림밸런스 분홍이/초록이 35일분 택 1,44000,19900,999,24100,54.8,331
미쟝센,[2023어워즈] 미쟝센 퍼펙트 오리지널 세럼 110ML 더블 어워즈 한정기획(+세럼 30ML),30000,19900,999,10100,33.7,332
릴리바이레드,릴리바이레드 무드 라이어 벨벳틴트,13000,9500,999,3500,26.9,333
에스트라,에스트라 아토베리어365 바디로션 400ml,33000,26400,999,6600,20.0,334
바이브랩,[홍현희PICK]바이브랩 리바이브 테라피 헤어 스칼프 앤 브로우 앰플,24000,22800,322,1200,5.0,335
클리오,[NEW] 클리오 크리스탈글램밤,18000,11970,326,6030,33.5,336
쉬크,쉬크 인튜이션 면도날 3입 4종 택1 (레몬베리/내추럴/코코넛/혼합),14900,11900,999,3000,20.1,337
덴티스테,덴티스테 뉴 플러스화이트 치약 60g/100g/160g 3종 택 1,6900,5400,999,1500,21.7,338
아크네스,[단독기획] 아크네스 3초 진정 패치 1+1기획 (72매+72매),9500,9300,999,200,2.1,339
구달,[1+1 기획] 구달 맑은 어성초 진정 무기자차 선크림 50ml 1+1 기획 SPF50+ PA++++,20000,17100,999,2900,14.5,340
라로슈포제,[한정기획] 라로슈포제 에빠끌라 딥클렌징포밍크림 125ml 기획 (+에빠폼 15ml),28000,22400,999,5600,20.0,341
바솔,바솔 이너밸런싱 포밍워시 150ml 티슈 5매 증정기획,24000,16900,999,7100,29.6,342
코스알엑스,[총180매대용량] 코스알엑스 원스텝 오리지널 클리어 패드 더블 기획 (90매+90매),32000,25600,999,6400,20.0,343
메디온,[이선빈Pick] 메디온 락토리메디 레이디스 이너 케어 젤 2.0 2종 택1 (5개입/10개입),19900,16900,999,3000,15.1,344
제이준,[영양탄력] 제이준 콜라겐 스킨 핏 탄력 강화 마스크팩 1매,3900,1300,47,2600,66.7,345
메디힐,[스티커증정] 메디힐 블랙헤드 멜팅 클리어 코팩 4매 (빤쮸토끼 기획),14000,11400,787,2600,18.6,346
온더바디,온더바디 발팩하자 풋마스크 (2회분),9900,3500,999,6400,64.6,347
미쟝센,미쟝센 살롱10 단백질 트리트먼트 에센스팩 990ml (손상/극손상) 2종 택1,21900,18900,999,3000,13.7,348
바이오힐보,[NEW] 바이오힐보 판테셀 리페어시카 크림미스트 120mL(기획/단품),18000,12600,999,5400,30.0,349
토니모리,[NEW] 토니모리 겟잇틴트 글레이즈밤 5종,18000,14400,617,3600,20.0,350
닥터브로너스,닥터브로너스 퓨어 캐스틸 솝 950ml 10종 택 1,33000,28050,999,4950,15.0,351
3CE,[NEW컬러/민니PICK]3CE 멀티 아이 컬러 팔레트(단품/기획),39000,29250,999,9750,25.0,352
웨이크메이크,[NEW/한정기획] 웨이크메이크 스트롱 블랙 틴팅 래쉬 앰플 (단품/기획),14000,12600,49,1400,10.0,353
헉슬리,헉슬리 퍼퓸 15ml 3종 중 택1,48000,41040,999,6960,14.5,354
푸드올로지,[택연pick]맨올로지컷 1100mg*60정(10일분),20900,18520,634,2380,11.4,355
필리밀리,필리밀리 히팅뷰러 2종 택1 (충전타입/건전지타입),22900,17600,999,5300,23.1,356
누즈,[NEW/블러셔]누즈 무스 케어 치크,19000,16150,250,2850,15.0,357
파파레서피,[온라인/단독기획]파파레서피 블레미쉬(광채) 효소 파우더 클렌저 더블 기획 세트(브러쉬+크림7ml 증정),36000,28800,52,7200,20.0,358
코링코,[단독]코링코 톡톡하라 필터 속눈썹 블랙 기획세트 9/10/11mm 120pcs,12000,9600,999,2400,20.0,359
아벤느,아벤느 클리낭스 클렌징 젤 400ml *피지잡는 *약산성클렌저,30000,21000,999,9000,30.0,360
넘버즈인,[탄력광채] 넘버즈인 3번 맑은결광 에센스 점보패드 70매 기획 (+10매 추가 증정),26000,18200,999,7800,30.0,361
웨이크메이크,[1월올영픽] 웨이크메이크 워터 글로우 코팅 파운데이션 (브러시기획/단품),38000,28500,215,9500,25.0,362
오브제,[덱스 PICK]오브제 무드체인지 립밤 3g,11900,10700,999,1200,10.1,363
비욘드,비욘드 엔젤아쿠아 수분 진정 크림 150ml 1+1 기획 (비건),25000,20800,999,4200,16.8,364
츠바키,츠바키 프리미엄 EX 리페어 마스크 180g 더블기획,34200,23900,999,10300,30.1,365
라운드랩,라운드랩 자작나무 수분 톤업 선크림 50ml 기획(클렌저 20ml 증정),25000,17500,999,7500,30.0,366
리쥬란,[피부특화 DNA성분] 리쥬란 힐러 스킨 프로텍션 마스크 1매/5매,28000,14000,999,14000,50.0,367
옵티프리,[증량] 옵티프리 익스프레스 (470mlx2+355ml),17900,15200,999,2700,15.1,368
피지오겔,[한정기획] 피지오겔 데일리뮨 글로우 에센스 70ml+앰플4ml+마스크팩1매 증정 기획,45000,39900,723,5100,11.3,369
삐아,[하이라이너 증정 기획] 삐아 라스트 오토 젤 아이라이너 기획/단품,9000,7900,999,1100,12.2,370
그로우어스,그로우어스 데미지 테라피 샴푸 500ml 기획(+크림트리트먼트 21ml 증정),26000,23400,999,2600,10.0,371
홀리카홀리카,홀리카홀리카 마이페이브 무드 아이팔레트,28000,19950,999,8050,28.7,372
메디힐,[단독기획] 메디힐 티트리 에센셜 마스크 10+1매 기획,20000,10000,999,10000,50.0,373
덴티스테,덴티스테 후레쉬 브레스스프레이 택1 (3개입/6개입),25900,18340,999,7560,29.2,374
유세린,유세린 하이알루론 3X 아이 크림 15ml,49000,39200,999,9800,20.0,375
바이탈뷰티,[파우치증정]바이탈뷰티 메타그린 슬림업 X포차코 기획세트,36000,27000,999,9000,25.0,376
아이소이,"[단독기획] 아이소이 속보습, 100시간 장수진 수분크림 70ml+15ml 기획",36000,27000,999,9000,25.0,377
지베르니,[리뉴얼] 지베르니 밀착 커버 파운데이션,33000,26900,999,6100,18.5,378
페리페라,페리페라 올테이크 무드라이크 팔레트,28000,22400,999,5600,20.0,379
웨이크메이크,[브러시기획] 웨이크메이크 믹스 블러링 볼륨 하이라이터 2COLOR (기획/단품),17000,14400,999,2600,15.3,380
조선미녀,조선미녀 산들쑥선스틱 18g,18000,14400,59,3600,20.0,381
라운드랩,라운드랩 포 맨 자작나무 토너/로션 200ml 2종세트 (쉐이빙폼 40ml증정),42000,31500,999,10500,25.0,382
센시안,[이선빈PICK] 센시안 압박밴드 택1(릴렉스/워크/나이트케어) (의료기기),21900,17900,999,4000,18.3,383
해서린,"해서린 스팟케어 패치 단품 (노란스팟, 붉은스팟)",3000,2200,999,800,26.7,384
웰라쥬,[단독기획] 웰라쥬 리얼 히알루로닉 100 크림 50ml 1+1 기획,39000,25900,999,13100,33.6,385
토리든,[단독기획] 토리든 밸런스풀 시카 진정 세럼 50ml 기획(+밸런스풀 크림 20ml),23000,16100,999,6900,30.0,386
달바,[이효리PICK][내 맘대로 DIY] 달바 화이트 트러플 더블 세럼 앤 크림 70g,78000,46800,812,31200,40.0,387
바이오더마,바이오더마 센시비오 H2O 500ml (펌프형),29000,21750,999,7250,25.0,388
라보에이치,라보에이치 두피강화(페어앤프리지아/블랑쉬앤우디)기획,19800,13900,999,5900,29.8,389
라운드랩,라운드랩 1025 독도 로션 400ml 대용량,39000,25600,999,13400,34.4,390
클리오,[NEW 붕세권 에디션] 클리오 쉬폰블러틴트,18000,11970,999,6030,33.5,391
SNP,SNP 골드 콜라겐 퍼펙션 아이패치 60매,23000,18400,999,4600,20.0,392
릴리바이레드,릴리바이레드 나인투나인 서바이벌 펜라이너,12000,9000,999,3000,25.0,393
더마토리,[혜림쌤 PICK] 더마토리 시카 거즈 패드 80매 (수분/진정),26000,18200,999,7800,30.0,394
더블유드레스룸,W.DRESSROOM 퍼퓸 핸드크림 50ml 8종,7900,5500,999,2400,30.4,395
아누아,[증량] 아누아 어성초 77 토너 500ml,45000,30000,999,15000,33.3,396
티스,[블랙헤드쏙]티스 딥 오프 클렌징 오일 320mL,18000,13500,999,4500,25.0,397
딜라이트 프로젝트,딜라이트 프로젝트 쫀득한 복숭아말랭이 125g 어워즈 한정 기획 (2023),7600,5800,999,1800,23.7,398
어뮤즈,[장원영틴트] 어뮤즈 젤핏 틴트,20000,18050,999,1950,9.8,399
메이크프렘,[단독기획]메이크프렘 세이프 미 릴리프 모이스처 비건 클렌징오일 리필기획 (210ml+100ml 증정),28000,21000,999,7000,25.0,400
넘버즈인,[흔적미백] 넘버즈인 5번 글루타치온C 흔적 필름패드 70매 기획(+6매 추가 증정),28000,21000,999,7000,25.0,401
퓌,[파우더증정] 퓌 쿠션 스웨이드 미니파우더 증정기획 (본품+리필+미니파우더),35000,21000,999,14000,40.0,402
바른생각,[단독기획] 바른생각 젤 150ml (+50ml) 2종 택 1 (젤 스탠다드 / 젤 내추럴 수딩),15900,14900,999,1000,6.3,403
온더바디,[화제의아이템] 온더바디 발을씻자 코튼 풋샴푸 대용량 510ml 3종(레몬/자몽/쿨링) 택1,13800,6600,999,7200,52.2,404
이즈앤트리,[흔적패드] 이즈앤트리 어니언 뉴페어 클리어 패드 60매 (+20매 리필 증정기획),26000,17900,999,8100,31.2,405
메디힐,메디힐 비타 에센셜 마스크 10매입,20000,10000,999,10000,50.0,406
닥터지,닥터지 그린 마일드 업 선 플러스 기획(50ml+20ml),29000,24650,999,4350,15.0,407
라로슈포제,라로슈포제 에빠끌라 울트라 컨센트레이티드 세럼 30ml 기획 (+에빠끌라폼15ml+유비데아 톤업클리어 2ml),48000,36000,442,12000,25.0,408
티타드,티타드 프레시 브레스 플러스 치약 100g 기획(+20g 증정),11000,9900,999,1100,10.0,409
스트라이덱스,[고우림 PICK] 스트라이덱스 약알칼리성 바하 폼클렌저 기획 (150ml+15ml),9900,6390,999,3510,35.5,410
아이디얼포맨,[온라인단독/더블기획]아이디얼 포맨 퍼펙트 올인원 스페셜 기획(150ml+150ml+20ml+클렌징폼(20ml)),48000,29000,999,19000,39.6,411
쉬크,쉬크 인튜이션 제모기(기+날2입) 2종 택 1,15900,12900,999,3000,18.9,412
유시몰,[한정기획] 유시몰 화이트닝 미백치약 106g+20g (가글 9ml 추가 증정 기획),16900,12900,999,4000,23.7,413
어노브,어노브 딥 데미지 리페어 샴푸 500g (단백질 앰플 샴푸),18000,14900,999,3100,17.2,414
레이비,레이비 바디로션 350ml 3종 택1,13900,10900,999,3000,21.6,415
바닐라코,[쩡유 공동개발] 바닐라코 쉬어 벨벳 베일 틴트 4.2g,16000,12800,999,3200,20.0,416
아비브,[2023어워즈] 아비브 어성초 카밍 토너 스킨부스터 더블 기획 (200ml+200ml),39000,23900,999,15100,38.7,417
아비브,[1월 올영픽] 아비브 콜라겐 겔 마스크 부활초 젤리 4매 기획,20000,11000,999,9000,45.0,418
테라브레스,[2023 어워즈] 테라브레스 오랄린스 마일드민트 1L 어워즈 한정기획 (+150ml 증정),22900,20100,999,2800,12.2,419
라네즈,[단독 기획] 라네즈 워터 슬리핑 마스크 70ml 기획(+30ml+시슬마10ml),34000,23800,999,10200,30.0,420
얼터너티브스테레오,[NEW] 얼터너티브스테레오 립 포션 아쿠아 글로우,19000,17100,999,1900,10.0,421
일소,"[로운PICK] 일소 슈퍼 멜팅 세범 소프트너 150ml 기획 (+솜 40매 증정,피지연화제)",21000,16900,616,4100,19.5,422
릴리바이레드,릴리바이레드 스키니메스 브로우 펜슬,8000,6000,999,2000,25.0,423
이너시아,이너시아 유기농 생리대 번들팩 4종 택 1(중형 24P/ 대형 24P/ 중형+대형48P/ 라이너54P),8500,8100,999,400,4.7,424
라로슈포제,라로슈포제 히알루 B5 세럼 기획 (세럼 30ml+1.5ml+똘러리앙로션15ml),54000,43200,999,10800,20.0,425
롬앤,롬앤 한올 플랫 브로우,11000,7900,999,3100,28.2,426
CKD,[은또PICK/4+1] CKD 레티노콜라겐 저분자300 모공탄력 마스크 4+1 기획,20000,12260,999,7740,38.7,427
브링그린,[NEW]브링그린 티트리시카수딩토너 500mL한정기획(+100mL증정),27000,19440,999,7560,28.0,428
리쥬란,[8주만에 피부나이 -4살] 리쥬란 바이옴 힐러 유스 포뮬러 앰플 30ml 기획,63000,42500,197,20500,32.5,429
메디큐브,[유재석 PICK] 메디큐브 제로 모공 패드 2.0 70매,24000,22800,999,1200,5.0,430
씨퓨리,[수지 PICK / 5종임상] 씨퓨리 닥터33 탈모앰플 20ml,24900,22800,114,2100,8.4,431
식물나라,[대용량] 식물나라 제주탄산수 퀵 립앤아이리무버 300ml,16000,8900,999,7100,44.4,432
더마토리,[70매+70매 한정기획] 더마토리 프로 트러블 모공 패드 총 140매 리필기획,39000,27300,999,11700,30.0,433
브링그린,[백현클렌징폼] 브링그린 뱀부차콜모공정화클렌징폼200mL더블기획,19000,13900,999,5100,26.8,434
웨이크메이크,[컨실러펜슬기획] 웨이크메이크 디파이닝 커버 컨실러 6COLOR (기획/단품),14000,11900,999,2100,15.0,435
페리페라,페리페라 스피디 스키니 브로우 마스카라,8000,7600,999,400,5.0,436
정샘물,정샘물 에센셜 물 마이크로 피팅 미스트 55ml,20000,19000,210,1000,5.0,437
해피문데이,해피문데이 이지 탐폰 3종 택 1 (라이트 / 레귤러 / 슈퍼),5500,4900,999,600,10.9,438
릴리바이레드,[글리터 한정기획] 릴리바이레드 무드키보드 8colors (기획/단품),27000,18900,999,8100,30.0,439
성분에디터,성분에디터 그린토마토 포어 리프팅 앰플 토너 350ml+100ml 기획,21000,18900,742,2100,10.0,440
클리오,클리오 킬커버 하이 글로우 쿠션(본품+리필 기획),36000,27000,999,9000,25.0,441
3CE,[민니PICK] 3CE 헤이지 립 클레이,20000,16000,999,4000,20.0,442
페리페라,[약과몰입] 페리페라 맑게 물든 선샤인 치크,8000,6400,999,1600,20.0,443
웨이크메이크,[리뉴얼/1+1기획] 웨이크메이크 철벽 브러쉬 아이라이너 3COLOR 1+1 기획 / 단품,13000,11700,999,1300,10.0,444
라운드랩,[NEW] 라운드랩 소나무 진정 시카 마스크 1매,3000,1500,999,1500,50.0,445
프리메라,프리메라 알파인 베리 워터리 크림 50ml 단품/기획 택1,41000,32800,999,8200,20.0,446
아이소이,아이소이 불가리안 로즈 립 트리트먼트 밤 2종 택1,19800,15800,999,4000,20.2,447
에뛰드,[NEW컬러] 에뛰드 글로우 픽싱틴트,14000,11200,999,2800,20.0,448
릴리바이레드,릴리바이레드 쥬시 라이어 워터틴트(AD) 4.8g,13000,9500,999,3500,26.9,449
듀오,"듀오 퀵셋 속눈썹 접착제 14g ( 다크, 클리어 ) 튜브 타입 택 1",19000,15200,999,3800,20.0,450
루톤,루톤 여성 두피용 알파에르겐 탈모샴푸 500ml+70ml 증정기획,31000,25800,999,5200,16.8,451
로레알,[한소희Pick]로레알파리 토탈리페어5 트리트먼트 헤어팩 4종 택1,33900,23300,999,10600,31.3,452
유리아쥬,유리아쥬 제모스 토너 (본품500ml+250ml 추가 증정),43000,39900,999,3100,7.2,453
정샘물,정샘물 스킨 누더 커버 레이어 쿠션(본품+리필),42000,39900,999,2100,5.0,454
필리밀리,필리밀리 세라믹바디괄사(파우치 포함),18900,17900,999,1000,5.3,455
티젠,[단독기획] 티젠 콤부차 30T 10종 택1,19500,12900,999,6600,33.8,456
페리페라,페리페라 잉크더벨벳AD,10000,8000,999,2000,20.0,457
카밀,[NEW] 카밀 핸드앤네일 로션 클래식 125ml,8900,4900,999,4000,44.9,458
시루콧토,시루콧토 우루우루 40매 4개입/ 7개입 기획 택 1,12900,10900,999,2000,15.5,459
뉴칸,[1월 올영픽]뉴칸 더블파워 밀크씨슬+멀티비타민 7개입 (7일분),34000,25500,999,8500,25.0,460
눅스,[1월올영픽/소의튜브PICK] 눅스 윌 프로디쥬스 멀티 드라이 오일 100ml 기획 (+프리미엄 우드 괄사),52000,39500,407,12500,24.0,461
마녀공장,[더블기획] 마녀공장 비피다 바이옴 콤플렉스 앰플 30ml X2 기획,43000,25440,999,17560,40.8,462
라보에이치,라보에이치 탈모증상완화 샴푸 두피강화 (333ml+50ml),19800,14900,999,4900,24.7,463
에스쁘아,[증량기획] 에스쁘아 워터 스플래쉬 선크림 세라마이드 60ml (+20ml 추가 증정),22000,17600,999,4400,20.0,464
달바,[국민미스트 진정 VER] 달바 화이트 트러플 바이탈 스프레이 세럼 100ml,29000,20900,999,8100,27.9,465
힐링버드,[트와이스 나연PICK] 힐링버드 노워시 트리트먼트 오리지널 200ml+데미지 트리트먼트 100ml 한정 기획,27000,17500,999,9500,35.2,466
메디힐,메디힐 WHP 미백수분 블랙마스크 EX,3000,1500,999,1500,50.0,467
박준뷰티랩,[전문가용]박준뷰티랩 익스트림 매트 하드 헤어왁스 120g,15000,7800,673,7200,48.0,468
브링그린,브링그린 모이스처모먼트 핸드크림 30ml 6종 택1,4300,2400,999,1900,44.2,469
포맨트,[1등 향수]포맨트 시그니처 퍼퓸 50ml 2종 택1 (코튼키스/코튼허그),39000,37000,999,2000,5.1,470
인클리어,[의료기기] 인클리어 질세정기 단품/기획 3종 중 택 1 (3P/10P/9+3P 기획),26900,22400,999,4500,16.7,471
바솔,바솔 이너밸런싱 포밍워시 150ml + 150ml 증정 기획,36000,25000,999,11000,30.6,472
스튜디오17,스튜디오17 메이크업 브러쉬(19종 중 택1),3200,2700,999,500,15.6,473
넘버즈인,[수분진정] 넘버즈인 1번 청초 진정맑은 물막선크림 50ml+50ml 듀오기획 (SPF50+PA++++),26000,24700,999,1300,5.0,474
토코보,토코보 비타 글레이즈드 립 마스크 20ml,20000,17000,999,3000,15.0,475
센텔리안24,[최신상크림]센텔리안24 마데카 크림 타임 리버스 50ml,38000,17000,18,21000,55.3,476
더마틱스울트라,[의료기기] 더마틱스 스카플러스 스틱 5g 2종 (더블기획/단품),23900,16730,999,7170,30.0,477
키스미,[초슬림 브러시/리뉴얼] 키스미 히로인메이크 마이크로 마스카라 어드밴스드 필름 N 4.5g,22000,14300,999,7700,35.0,478
덴프스,[1월 올영픽]덴프스 덴마크 유산균이야기 30캡슐(1개월분),23000,16900,541,6100,26.5,479
브이앤에이뷰티,[앰플증정기획]V&A 미백보습크림 (50ml+20ml앰플),62000,37910,703,24090,38.9,480
라운드랩,[2023어워즈/4년연속] 라운드랩 1025 독도 토너 500ml 어워즈 한정기획(+크림50ml+패드10매),45000,29800,999,15200,33.8,481
종근당건강,프로메가 알티지 오메가3 듀얼 40 캡슐 더블 기획세트 (40일분),29800,19900,676,9900,33.2,482
에스쁘아,[장이나 PICK/단독기획] 에스쁘아 비벨벳 플루이드 파운데이션 컨실러 증정 기획(본품 30g+컨실러 정품),37000,29600,798,7400,20.0,483
필리밀리,필리밀리 앞머리 헤어롤,3000,2800,999,200,6.7,484
리얼베리어,[대용량/단독기획] 리얼베리어 익스트림 크림 70ml+30ml 기획,38000,29500,999,8500,22.4,485
모레모,[1월 올영픽]모레모 워터 트리트먼트 미라클 10 480ml 클로버 에디션 기획(90ml 증정),49000,23900,999,25100,51.2,486
키스미,[한정수량] 키스미 히로인메이크 스피디 마스카라 리무버 더블 기획,26000,16380,999,9620,37.0,487
우르오스,우르오스 올인원 200ml 2종 택 1,29700,23700,999,6000,20.2,488
홀리카홀리카,[깡나PICK] 홀리카홀리카 하트크러쉬 베어 글레이즈 틴트,14000,9800,78,4200,30.0,489
셀리맥스,셀리맥스 어성초 바하 지우개 필링 패드 60매,17000,11500,999,5500,32.4,490
VDL,VDL 엑스퍼트 컬러 프라이머 포 아이즈,16000,13600,999,2400,15.0,491
아누아,아누아 어성초 77토너 + 어성초 70 로션 듀오 기획세트,49700,36700,999,13000,26.2,492
딥트3일,"[1월 올영픽][주현영, 이나연 찐템]딥트 3일 애플번 30정 (15일분)",43000,36700,102,6300,14.7,493
리파,[엔믹스 Pick] 리파 하트 브러시 7종 택1,29800,28900,999,900,3.0,494
그로우어스,그로우어스 씨솔트 테라피 샴푸 500g 기획(+ 샴푸 21g 증정),26000,23400,776,2600,10.0,495
키스미,[NO.1 마스카라] 키스미 히로인메이크 마스카라 EX (롱/볼륨),18000,13500,999,4500,25.0,496
좋은느낌,좋은느낌 유기농 입는 무표백 오버나이트 2종 택 1 (M / L 4P),10700,9630,999,1070,10.0,497
셀퓨전씨,[베스트/밀착톤업] 셀퓨전씨 토닝 썬스크린 100 50ml 기획(쿨링패드 2매입*2),39000,16000,999,23000,59.0,498
바티스트,바티스트 드라이샴푸 50ml/200ml 11종 택 1,7500,5900,999,1600,21.3,499
세타필,세타필 모이스춰라이징 로션 500ml 기획 (크림 85g 증정),18200,15900,999,2300,12.6,500
유리아쥬,유리아쥬 진피 마일드 젤 200ml+50ml 증정 기획,21000,18900,999,2100,10.0,501
푸드올로지,[서현Pick]콜레올로지 티 하비탈출 15포 (15일분),35800,28300,616,7500,20.9,502
필리밀리,필리밀리 미니 메이크업 브러시세트 (5종),23000,18800,999,4200,18.3,503
포엘리에,포엘리에 이너퍼퓸 9종 택 1,15900,11130,999,4770,30.0,504
메디큐브,메디큐브 제로 모공 패드 마일드 70매,24000,22800,459,1200,5.0,505
갸스비,갸스비 수퍼하드 셋&킵 스프레이 263ml+263ml,13700,13000,275,700,5.1,506
고려은단,고려은단 비타민C1000 이지+비타민D 120정 (60일분),13000,10900,999,2100,16.2,507
프로티원,[보틀증정] 프로티원 단백질쉐이크 4종 택1 490g (1ea/2ea),29900,26910,137,2990,10.0,508
에스트라,에스트라 에이시카365 소프트 진정 팩 패드 60매,28000,22400,999,5600,20.0,509
VDL,VDL 컬러 코렉팅 프라이머,23000,18400,934,4600,20.0,510
스킨앤랩,[지안씨 Pick]스킨앤랩 베리어덤 인텐시브 크림 50ml 기획 (+ 크림 30ml 증정),23000,18400,999,4600,20.0,511
닥터지,닥터지 레드 블레미쉬 클리어 퀵 수딩 패드 더블 기획세트(70매+70매),50000,35000,999,15000,30.0,512
라운드어라운드,라운드어라운드 편백 클린 스프레이 골라담기,18000,10900,999,7100,39.4,513
저스트에즈아이엠,[2023어워즈/윤그린PICK] 아이엠 샴푸 인텐시브 스칼프 케어 기획세트 1종/480ml 3종/700ml 2종 택1),37000,29600,999,7400,20.0,514
라네즈,[1월올영PICK/선착순워터뱅크4종키트] 라네즈 워터뱅크 인텐시브 크림 45ml 배드블루 콜라보 기획,39000,27500,81,11500,29.5,515
메디힐,메디힐 콜라겐 에센셜 마스크 1매,2000,1000,999,1000,50.0,516
해피바스,[비건] 해피바스 오리지널 컬렉션 바디워시 910G 7종 택1,9900,8500,999,1400,14.1,517
한율,한율 달빛유자 수면팩 70ml (+35ml 증정기획),34000,27200,999,6800,20.0,518
아크로패스,아크로패스 트러블큐어 6매,9800,8800,999,1000,10.2,519
바이탈뷰티,바이탈뷰티 메타그린 슬림업 30일분,36000,27000,999,9000,25.0,520
클리오,[NEW] 클리오 킬커버 스킨 픽서 쿠션,36000,27000,242,9000,25.0,521
화이트,화이트 순한순면 라이너 4종 택 1 (일반 / 롱 / 수퍼롱),5900,3250,999,2650,44.9,522
아누아,[단독기획] 아누아 어성초 80 수분 진정 앰플 기획 (30ml+15ml),29000,21500,999,7500,25.9,523
베네피트,[태연 Pick] 베네피트 틴트 6종 택1 (차차틴트 외),31000,26350,999,4650,15.0,524
오킵스,[극강보습] 오킵스 워킹핸즈 핸드크림 자(96g)/튜브(85g) 택1,13000,8300,999,4700,36.2,525
오설록,오설록 20입 티백 5종 택 1,9500,7000,445,2500,26.3,526
바이오더마,[온라인몰 단독기획]바이오더마 하이드라비오 세럼 더블기획(40ml+40ml),52000,44200,999,7800,15.0,527
후시다인,[안다 PICK]후시다인 더마 트러블 밸런싱 세럼 40g,35000,26250,999,8750,25.0,528
팁토우,[한정기획/윈터트리오세트] 팁토우 컬러 네일 48종,13000,11050,999,1950,15.0,529
넘버즈인,[단독기획] 넘버즈인 2번 딥클린 생크림 클렌징폼 더블 기획 (120ml+120ml),14000,9900,999,4100,29.3,530
보로탈코,[1월 올영픽/단독기획] 보로탈코 크레마 벨루탄테 크림 30ml 더블 기획 (30ml+30ml),15000,9900,999,5100,34.0,531
포맨트,포맨트 시그니처 코튼 스프레이 200ml (코튼허그),23000,21000,271,2000,8.7,532
어노브,어노브 볼륨 업 컬링 에센스 147ml (수분 컬크림),16000,14200,999,1800,11.2,533
아벤느,[올리버쌤PICK]아벤느 제라캄 뉴트리션 로션 400ml 한정기획 (+200ml) (와다다곰 콜라보),53200,33100,999,20100,37.8,534
좋은느낌,좋은느낌 입는 데이팬티 2종 택 1 (중형 / 대형 4P),9600,8160,550,1440,15.0,535
에스트라,에스트라 테라크네365 클리어 딥 클렌징 폼 200g,23000,20700,999,2300,10.0,536
그로우어스,그로우어스 씨솔트 테라피 두피스케일러 대용량 250g+30g 증정기획,27000,25700,999,1300,4.8,537
브링그린,[더블기획] 브링그린 티트리시카트러블클렌징폼 200mL더블기획_NEW,19000,13900,999,5100,26.8,538
아이소이,아이소이 BR 블레미쉬 케어 업 세럼 더블기획 (20ml+20ml),54000,43200,999,10800,20.0,539
아비브,[1월 올영픽] 아비브 부활초 콜라겐 패드 퍼밍 터치 60매 기획 (+10매 추가 증정),24000,16800,65,7200,30.0,540
티트리트,티트리트 푸룬딥스트롱 180ml,4500,3600,999,900,20.0,541
러븀,러븀 포어 리셋 머드 마스크 5매입,25000,16700,258,8300,33.2,542
아벤느,아벤느 이드랑스 에센스인로션 200ml 한정기획 (+젠틀토닝로션 200ml),49000,32200,863,16800,34.3,543
퓌,퓌 올트임 듀얼라이너,17000,13600,999,3400,20.0,544
아누아,아누아 어성초 77 진정 마스크 1매,4000,2000,999,2000,50.0,545
커리쉴,[1월올영픽/실키오일세럼13ml증정]커리쉴 실키 오일 세럼 70ml,25000,20000,999,5000,20.0,546
더마비,더마비 데일리 모이스처 바디로션 더블 기획 (500ml+500ml),39000,24900,999,14100,36.2,547
파넬,파넬 시카마누 약산성 바디미스트 150ml,23000,19900,999,3100,13.5,548
라로슈포제,라로슈포제 NEW 시카플라스트 밤B5+ 40ml,25000,19900,999,5100,20.4,549
프롬잇,프롬잇 프로틴칩 6종 택1,2700,2500,999,200,7.4,550
라우쉬,라우쉬 샴푸 200ml 8종 택1 (스위스허벌/윌로우바크/콜츠푸트/씨위드/멜로우/아보카도/에그오일),26000,21500,999,4500,17.3,551
메디힐,메디힐 캡슐100 바이오 세컨덤 수분 하이드로 1매,5000,2500,999,2500,50.0,552
비페스타,비페스타 클렌징오일 브라이트닝 230ml (각질&블랙헤드 제거),16000,10900,999,5100,31.9,553
반디,[다영PICK] 반디 핑크다이아 손톱영양제 증정기획,20000,16000,999,4000,20.0,554
릴리바이레드,릴리바이레드 앙큼라이어 코팅틴트(AD) 4g,13000,9030,999,3970,30.5,555
인터미션,[고이진 PICK] 인터미션 레스트 업 세럼 크림 70ml,28900,24500,94,4400,15.2,556
포지타노,포지타노 레몬캔디 200g,8900,7400,999,1500,16.9,557
아비브,아비브 약산성 pH 시트 마스크 아쿠아 핏 1매,4000,2400,999,1600,40.0,558
토리든,[단독기획] 토리든 다이브인 저분자 히알루론산 크림 80ml 기획(+크림 20ml 추가증정),21000,15700,999,5300,25.2,559
온더바디,[마루는강쥐X온더바디] 온더바디 코튼풋 발각질팩하자 풋필링팩 2개입 (1회분),9900,5950,0,3950,39.9,560
센트룸,[1월 올영픽]센트룸 멀티비타민 50정 우먼/맨 중 택 1 (50일분),27000,24000,999,3000,11.1,561
클리오,클리오 킬커버 파운웨어 파운데이션,34000,23800,999,10200,30.0,562
에이지투웨니스,[수영PICK 커버 새틴 미니 쿠션 증정]AGE20S 노블 커버 새틴 쿠션(본품+리필),38000,30400,504,7600,20.0,563
바닐라코,바닐라코 얼티밋 화이트 쿠션 모이스처 (본품+리필),38000,30400,941,7600,20.0,564
클리오,[단독기획] 클리오 수퍼프루프 브러쉬 라이너 기획 (립앤아이리무버미니 증정),18000,12600,999,5400,30.0,565
미쟝센,미쟝센 살롱10 단백질 샴푸990ml(손상/극손상)2종 택1,21900,18900,999,3000,13.7,566
생활약속,[단독기획]생활약속 기분전환 알파플러스 (본품10포+1포 추가 증정),18000,15300,999,2700,15.0,567
달바,[촘촘 수분팩] 달바 화이트 트러플 너리싱 트리트먼트 마스크 5매,25000,12500,999,12500,50.0,568
닥터지,[NEW] 닥터지 레드 블레미쉬 클리어 수딩 토너 300ml+300ml 듀오기획,46000,39900,999,6100,13.3,569
디어스킨,[윤다영PICK]디어스킨 에어엠보 7종 택 1 (생리대 / 라이너 / 오버나이트),6900,6210,999,690,10.0,570
가히,가히 멀티밤 리필형 기획 (본품1개+리필1개),49000,39800,999,9200,18.8,571
필리밀리,[레오제이 공동개발]필리밀리 쉐딩브러시 3종(코/턱/헤어라인),9500,8200,999,1300,13.7,572
웨이크메이크,웨이크메이크 네일케어 핑크영양제 2종 택1,5000,4500,999,500,10.0,573
아베다,아베다 스칼프솔루션 리플레니싱 컨디셔너 1000ml,220000,187000,0,33000,15.0,574
라운드랩,[대용량] 라운드랩 1025 독도 클렌저 200ml 더블기획,28000,23200,698,4800,17.1,575
라네즈,라네즈 네오 파우더 7g,20000,15000,999,5000,25.0,576
컬러그램,컬러그램 밀크 영롱 섀도우 7 COLOR,9800,8300,999,1500,15.3,577
포맨트,포맨트 시그니처 올인원 에센스 96ml,28900,23100,383,5800,20.1,578
필리밀리,필리밀리 메이크업브러시클렌저,7500,6700,957,800,10.7,579
라타플랑,라타플랑 미나리 진정 수분크림 75ml,24000,18240,861,5760,24.0,580
유기농본,유기농본 울트라슬림 팬티라이너 3팩 2종 택 1 (일반 34P / 롱 28P),12900,9900,999,3000,23.3,581
오센트,오센트 퍼퓸샤쉐 대용량 기획 2종 중 택 1(포레스트 기획 / 러브 기획),14000,9900,999,4100,29.3,582
토니모리,[단독기획] 토니모리 원더 세라마이드 모찌 토너 (본품500ml+100ml),15000,12000,999,3000,20.0,583
리쥬란,[리쥬란 독자소재_저자극 안심성분] 리쥬란 더마힐러 모이스처 트리트먼트 마스크팩 5매 (온),28000,14600,183,13400,47.9,584
데이지크,[NEW컬러] 데이지크 프루티 립잼 4g 13종 택1,17000,11900,999,5100,30.0,585
블리브유,[NEW] 블리브유 더 리얼 비타 C 20 앰플 12ml,32000,22410,85,9590,30.0,586
비판톨,[디렉터파이 PICK] 비판톨 더마 바디로션 400ml,28000,22400,465,5600,20.0,587
웨이크메이크,웨이크메이크 벨벳 블러링 매트 스틱 10COLOR,18000,14400,999,3600,20.0,588
바닐라코,[재출시] 바닐라코 볼륨 립 플럼퍼 3.8g (맥시/라이트 택1),16000,14400,942,1600,10.0,589
반디,반디 네일큐어 단단강화제&단백질영양제,15000,12000,999,3000,20.0,590
아이오페,아이오페 맨 올데이 퍼펙트 올인원 120ml 기획(+30ml 증정),38000,28500,332,9500,25.0,591
어노브,[2023어워즈]어노브 딥 데미지 트리트먼트 EX 320ml 어워즈기획(텐더블룸320ml+웜페탈320ml+샴푸52ml),42000,28500,999,13500,32.1,592
젬소,[리뉴얼]젬소 아이래쉬 앤 아이브로우 멀티액티브 세럼,40900,38000,430,2900,7.1,593
라운드랩,라운드랩 자작나무 수분 패드 (본품80매+10매 추가 증정),25000,17500,999,7500,30.0,594
바디판타지,바디판타지 바디스프레이 골라담기 (94ml / 기획세트),8900,6900,999,2000,22.5,595
라보에이치,라보에이치탈모증상완화샴푸 두피강화 리필팩 333ml*2입기획,27900,21900,999,6000,21.5,596
일리윤,[1월 올영픽] 일리윤 울트라 리페어 로션 600ML(올영 단독용량),33900,21900,999,12000,35.4,597
케어플러스,케어플러스 스팟커버 패치 카밍 96매,7200,6160,999,1040,14.4,598
스킨1004,[리프세이프]스킨1004 마다가스카르 센텔라 히알루-시카 워터핏 선 세럼 50ml,19000,14000,410,5000,26.3,599
스킨푸드,[피지쓱싹] 스킨푸드 미나리 클리어 패드 60매,26000,17290,999,8710,33.5,600
메디힐,[NEW] 메디힐 대나무 숯 4D 블랙 마스크 1매,3000,1500,999,1500,50.0,601
셀퓨전씨,셀퓨전씨 레이저 리쥬버네이션 크림 (본품 50ml+20ml 추가 증정),40000,28000,999,12000,30.0,602
라로슈포제,라로슈포제 유비데아 안뗄리오스 톤업 선크림 30ml 기획 (클리어 / 로지 택1),35000,28000,999,7000,20.0,603
닥터포헤어,[5년연속어워즈수상]닥터포헤어 폴리젠 샴푸 750ml 어워즈 기획(바이오-3 샴푸100ml*2+씨솔트 스케일러50g),38000,27900,999,10100,26.6,604
에뛰드,[리뉴얼] 에뛰드 피지쏙파우더,8000,6000,999,2000,25.0,605
필리밀리,필리밀리 투명한 속눈썹 접착제 7g,6000,4800,246,1200,20.0,606
푸드올로지,[서현Pick]콜레올로지 600mgX60정(1개월분),45800,36950,790,8850,19.3,607
니베아,니베아 SOS케어 바디로션 더블 기획 (400ml+400ml),19800,16900,999,2900,14.6,608
유시몰,[한정기획] 유시몰 치약 106g 더블기획 (106g+106g+스퀴저),18900,16900,999,2000,10.6,609
오센트,오센트 퍼퓸샤쉐 4종/에어퍼퓸 3종 택1,7000,5600,999,1400,20.0,610
쏘내추럴,쏘내추럴 올 데이 메이크업 픽서 75ml 기획(+15ml 젤 픽서),18000,13500,999,4500,25.0,611
구달,구달 청귤 비타C 잡티케어 세럼마스크 4매입,8000,7200,999,800,10.0,612
아비브,[1월 올영픽] 아비브 어성초 카밍 토너 스킨부스터 500ml 기획 (+화장솜 30매 증정),45000,27000,999,18000,40.0,613
그로우어스,그로우어스 데미지 테라피 헤어 크림 트리트먼트 220ml 기획(+크림트리트먼트 21ml 증정),22000,20900,327,1100,5.0,614
리얼베리어,[온라인단독] 리얼베리어 익스트림 크림 65ml 기획세트(+25ml),38000,26900,999,11100,29.2,615
닥터텅스,닥터텅스 스마트 치실 (색상 랜덤배송),6000,5600,999,400,6.7,616
바이오더마,바이오더마 시카비오 포마드 40ml,25000,16250,999,8750,35.0,617
유시몰,[2023 어워즈] 유시몰 화이트닝 미백치약 106g 한정기획 (+화이트닝 칫솔 증정),15900,12900,999,3000,18.9,618
클리오,클리오 프리즘 하이라이터 듀오,23000,16100,999,6900,30.0,619
Y.N.M,[강지영 추천템] YNM 허니 립밤 4종 택1,12000,8400,999,3600,30.0,620
락토핏,[2023어워즈/한정기획] 락토핏 골드 30포 더블기획 (+10포 증정) (70일분),27800,15900,999,11900,42.8,621
그린몬스터,[SINCE 1997] 그린몬스터 헐리우드48시간 원조 비건 클렌즈 947ml,35000,26000,999,9000,25.7,622
라운드랩,라운드랩 1025 독도 토너+로션기획 (토너 200ml+로션 200ml),32000,26000,999,6000,18.8,623
실크테라피,[한정기획] 실크테라피 에센스 145KIT(130+15) 3종 택1 (손상/극손상용),37000,25900,848,11100,30.0,624
메디힐,메디힐 워터마이드 에센셜 마스크 10매입,20000,10000,999,10000,50.0,625
마녀공장,마녀공장 퓨어 클렌징 오일 200ml,19900,15500,999,4400,22.1,626
마녀공장,마녀공장 허브 그린 클렌징 오일 200ml+ 약산성 소다폼 (20ml+20ml),19900,15500,999,4400,22.1,627
라네즈,라네즈 네오 쿠션 글로우 15g,30000,25500,155,4500,15.0,628
티트리트,[1월 올영픽]티트리트 여우티 11T+11T,13200,9900,999,3300,25.0,629
라네즈,[특별기획] 라네즈옴므 크림 스킨 옴므 올인원 150ml 기획(+25ml+25ml),28000,19600,924,8400,30.0,630
마몽드,[1초 아이돌 마스크] 마몽드 로즈 +PHA 리퀴드 마스크 80ml 기획 (+토너패드 30매 증정),28000,19600,999,8400,30.0,631
베네피트,베네피트 프리사이슬리 마이 브로우 펜슬,40000,34000,999,6000,15.0,632
다슈,다슈 데일리 볼륨업 컬크림 150ml (볼륨컬링 스타일링),15000,9800,999,5200,34.7,633
메이블린,[오예주PICK]메이블린뉴욕 얼티매트 립스틱 10colors,14000,9800,999,4200,30.0,634
로벡틴,[진정/각질] 로벡틴 닥터마스크 시카 1매,4000,2000,999,2000,50.0,635
메디힐,[NEW]메디힐 NMF 누드 겔 마스크 1매,4000,2000,999,2000,50.0,636
아베다,아베다 스칼프솔루션 밸런싱 샴푸 1000ml,192000,163200,0,28800,15.0,637
세노비스,세노비스 밀크씨슬 60캡슐 (2개월분),40000,25000,999,15000,37.5,638
가히,[김고은 Pick] 가히 멀티밤,37800,24900,999,12900,34.1,639
바이탈헬스,바이탈헬스 바이탈슬림 다이어트 올인원 데이 20포 (10일분),29900,19120,531,10780,36.1,640
AHC,AHC 허브솔루션 위치하젤 토너 500ml,15000,11900,70,3100,20.7,641
종근당건강,종근당건강 프로메가 오메가3 트리플 60캡슐 (장용성) (1개월분),14900,11900,999,3000,20.1,642
아로마티카,"아로마티카 퓨어앤소프트 여성청결제 170ml 2종 택1(기획세트, 단품)",19000,13300,999,5700,30.0,643
케어플러스,케어플러스 상처커버 스팟패치 빅(BIG) 81매,6500,6000,999,500,7.7,644
일리윤,[재구매1위] 일리윤 세라마이드 아토 집중크림 150ml +150ml 더블 기획,25500,18900,999,6600,25.9,645
피지오겔,[한정기획] 피지오겔 DMT포맨 증정 기획세트 2종 (플루이드 or 크림),65000,32900,999,32100,49.4,646
이브로쉐,[증량] 이브로쉐 모링가 리프레시 헤어식초 400ml (두피 진정/딥클렌징),17500,14500,999,3000,17.1,647
헤트라스,[1+1] 헤트라스 프리미엄 대용량 디퓨저 플라워샵향 500ml 2개입,18900,18500,299,400,2.1,648
라네이처,좋은느낌 라네이처 생리대 8종 택 1 (중형 / 대형 / 수퍼롱 / 라이너),16900,9300,736,7600,45.0,649
누즈,[NEW]누즈 무스 립추얼,17000,14450,321,2550,15.0,650
라로슈포제,라로슈포제 시카플라스트 로션 B5 판테놀 시카에센스 토너 200ml,32000,24000,999,8000,25.0,651
파티온,[5겹장벽크림] 파티온 노스카나인 트러블 크림 45ml,32000,24000,999,8000,25.0,652
그레인온,[관종언니 이지혜 Pick] 그레인온 골드 카무트 효소 30포 (30일분),28000,24000,453,4000,14.3,653
모레모,모레모 헤어 에센스 딜라이트풀 오일 150ml,23000,18400,551,4600,20.0,654
케이트,케이트 핏 레어 젤 펜슬,18000,14400,999,3600,20.0,655
에스쁘아,[단독기획] 에스쁘아 프로테일러 비내추럴 쿠션 본품 (+리필 증정),38000,32300,999,5700,15.0,656
뮤드,[NEW라떼톡기획] 뮤드 숄 모먼트 아이섀도우 팔레트 6종 중 택1 (기획/단품),32000,23900,896,8100,25.3,657
보다나,보다나 글램웨이브 봉고데기 프리볼트 36mm 4종 택1,83000,74000,999,9000,10.8,658
박준뷰티랩,박준 LPP 단백질 노워시 트리트먼트 헤어팩 200ml+ 80ml (증정기획),22000,14300,999,7700,35.0,659
달바,[올영 단독 증정/민감자차] 달바 워터풀 마일드 선크림 50ml,34000,23800,189,10200,30.0,660
오설록,오설록 콤부차 10입 50g (깔라망고/리치피치/애플파인 택 1),8000,5600,999,2400,30.0,661
비오텀,비오텀 클렌징 밀크 200ml,27800,23660,999,4140,14.9,662
아벤느,아벤느 트릭세라 로션 (본품200ml+100ml 추가 증정),33000,23600,999,9400,28.5,663
어뮤즈,[장원영립밤] 어뮤즈 듀 밤,20000,18050,999,1950,9.8,664
어뮤즈,[장원영 PICK] 어뮤즈 듀 틴트,20000,18000,999,2000,10.0,665
토코보,토코보 바이오 워터리 선크림 50mL SPF50+ PA++++,24000,18000,999,6000,25.0,666
코스알엑스,코스알엑스 풀핏 프로폴리스 시너지 토너 280ml 더블기획,44000,23500,999,20500,46.6,667
센텔리안24,[단독기획]센텔리안24 링클셀 코어 아이크림 25ml (코어 세럼 10ml 증정),38000,17900,386,20100,52.9,668
딜라이트 프로젝트,"딜라이트 프로젝트 쫀득한 군고구마, 망고말랭이 대용량 기획",9500,6900,999,2600,27.4,669
스킨베네핏,스킨베네핏 3종 새치커버 마스카라 (흑갈색/자연갈색/자연흑색),8900,6900,999,2000,22.5,670
코카콜라,[코카콜라본사직영]제로칼로리 뚱캔*24입 7종 택1(코카콜라/스프라이트/닥터페퍼/환타),20800,16440,284,4360,21.0,671
빠이러스,빠이러스 킬파이어 쿨가글액(플라워향) 500ml,15900,13900,246,2000,12.6,672
맥,MAC 립스틱,37000,31450,999,5550,15.0,673
로레알,로레알파리 엑셀랑스 파리지앵시크 9 colors (패션컬러),16000,10900,999,5100,31.9,674
바른생각,바른생각 워터리 핑거핏 20개입 (손가락 형),15900,10900,760,5000,31.4,675
미쟝센,[NEW] 미쟝센 퍼펙트 세럼 80ml [오리지널/스타일링/워터리/리치] 4종 택1,15000,8500,999,6500,43.3,676
닥터자르트,[올영단독] 닥터자르트 세라마이딘 바디오일 250ml,25000,17500,999,7500,30.0,677
라네즈,라네즈 네오 에센셜 블러링 피니시 파우더 7g,27000,22900,999,4100,15.2,678
라이블링,[1월 올영픽]라이블링 옐로우 클렌즈 15ml*10포입 (레몬맛),11900,8460,288,3440,28.9,679
피카소,피카소 라텍스 스퀘어 메이크업 스펀지 (6P/20P),13000,8650,999,4350,33.5,680
바세린,바세린 오리지널 프로텍팅 젤리 50ml,2200,2000,999,200,9.1,681
클리오,클리오 익스트림 젤프레소 펜슬라이너,12000,8400,999,3600,30.0,682
히말라야,[비건인증]히말라야 립밤 10g,3500,2800,999,700,20.0,683
갸스비,갸스비 기름종이 파우더 타입 70매+70매,7300,6500,999,800,11.0,684
일리윤,[약산성] 일리윤 대용량 세라마이드 아토 6.0탑투토워시 1000ml,23900,16900,999,7000,29.3,685
릴리바이레드,릴리바이레드 스태리아이즈 나인투나인 젤아이라이너,9000,6300,999,2700,30.0,686
모로칸오일,모로칸오일 헤어 트리트먼트 50ml (펌프포함),37000,30000,999,7000,18.9,687
이즈앤트리,[흔적앰플]이즈앤트리 어니언 뉴페어 B5 앰플 50ml,24000,16800,425,7200,30.0,688
한스킨,한스킨 클렌징오일 & 블랙헤드 (AHA/BHA/PHA) 300ml 3종 택 1,28000,16800,459,11200,40.0,689
메디힐,[NEW] 메디힐 레티놀 콜라겐 윤곽 마스크 4매 택 1 [앰플/크림],16000,8000,999,8000,50.0,690
좋은느낌,[단독기획] 좋은느낌 입는 오버나이트 3+1P 2종 택 1 (중형/대형),6500,6200,999,300,4.6,691
리터,리터 큐브 176g 3종 중 택1(요거트/포유/땡큐),9900,7900,999,2000,20.2,692
레모나,경남 레모나 루테인+비타민A 구미 60구미 (30일분),18900,10080,56,8820,46.7,693
한율,[박은빈 PICK] 한율 어린쑥 수분진정크림 55ml+25ml+마스크팩 기획,38000,29600,999,8400,22.1,694
에스쁘아,[올영픽] 에스쁘아 더브로우 컬러 픽싱 카라 3 Colors,16000,12800,999,3200,20.0,695
피카소,피카소 꼴레지오니 라운드 팁 트위저 퍼플,15000,9980,999,5020,33.5,696
3CE,3CE 쉬어 리퀴드 블러셔,17000,12750,615,4250,25.0,697
아떼,아떼 비건 릴리프 선 에센스 SPF50+PA++++ 어워즈 한정기획 외,42000,29400,999,12600,30.0,698
키스미,[가성비 라이너] 키스미 히로인메이크 스무스 리퀴드 아이라이너 P,14000,9900,999,4100,29.3,699
롬앤,롬앤 한올 픽스 마스카라,16000,9900,999,6100,38.1,700
투쿨포스쿨,[전소연PICK] 투쿨포스쿨 끌레어 틴트,12000,9900,999,2100,17.5,701
투쿨포스쿨,[전소연PICK] 투쿨포스쿨 플레르 워터 틴트,12000,9900,999,2100,17.5,702
비레디,[스완공동개발]비레디 시카페인 트러블리셋 세럼 40ml,38000,29000,102,9000,23.7,703
필리밀리,필리밀리 슬림한 족집게,3500,3300,999,200,5.7,704
헉슬리,[신규 향 출시/스퀴저 증정] 헉슬리 퍼퓸 핸드크림 6종 택 1,15000,12000,999,3000,20.0,705
어뮤즈,[NEW컬러출시] 어뮤즈 아이 컬러 팔레트(본품+듀얼 브러쉬),34000,28900,999,5100,15.0,706
달리프,달리프글램 텍스처 홀드 스프레이 (본품150ml+헤어롤 2개 증정)(뿌리 볼륨),15000,12400,745,2600,17.3,707
메디힐,[선우PICK]메디힐 레티놀 콜라겐 탄력 패드 100매 (+100매 더블증정 기획),39900,28800,738,11100,27.8,708
쏘피,쏘피 유기농 오버나이트 20P / 슈퍼롱 20P,14900,7450,506,7450,50.0,709
딜라이트 프로젝트,딜라이트 프로젝트 쫀득한 복숭아말랭이 62g,3800,3200,999,600,15.8,710
어반디케이,[2023 어워즈] 어반디케이 올나이터 세팅 픽서 118ml,46000,41400,999,4600,10.0,711
마비스,[다이어리증정] 마비스 치약 85ml 4종 택1,19900,15900,999,4000,20.1,712
홀리카홀리카,홀리카홀리카 마이페이브 인퓨징 블러쉬,17000,12240,196,4760,28.0,713
아베다,아베다 보태니컬 리페어 스트렝쓰닝 리브-인 트리트먼트 100ml,55000,41250,42,13750,25.0,714
닥터지,[베스트/민감피부] 닥터지 그린 마일드 업 선 플러스 40ml+40ml,37000,28500,999,8500,23.0,715
어반디케이,어반디케이 문더스트 모노 아이섀도우 기획/단품 택1 (올리브영 단독 스페이스카우보이+아이프라이머 미니 기획 외),33000,28050,999,4950,15.0,716
화이트,화이트 순한순면 탐폰 4종 택 1 (레귤러 / 슈퍼 8P / 16P),6000,4800,887,1200,20.0,717
아이디얼포맨,[피부진정/잡티완화]아이디얼 포 맨 시카 흔적 올인원 기획(150ml+50ml)(2023),30000,20810,447,9190,30.6,718
낫띵베럴,낫띵베럴 푸푸룬 340ml,4500,3100,513,1400,31.1,719
바이오더마,바이오더마 센시비오 H2O 250ml,17000,11900,999,5100,30.0,720
뮤드,뮤드 글라세 립 틴트 8종 택1,17000,15300,743,1700,10.0,721
라덴스,라덴스 베럴 혀클리너 리뉴얼 4color,9900,8910,999,990,10.0,722
머지,머지 더 퍼스트 젤 아이라이너,5900,5300,999,600,10.2,723
톤핏선,[프롬젤라PICK] 톤핏선 비건 파데프리 핑베 테라조쿠션  SPF50+ PA++++,24000,15120,999,8880,37.0,724
헤어플러스,헤어플러스 단백질 본드 워터에센스 200ml(뿌리는 에센스),18900,15100,999,3800,20.1,725
아크네스,아크네스 3초 진정 토너 패드 70매,21000,11500,999,9500,45.2,726
라로슈포제,라로슈포제 에빠끌라 H 토너 200ml (복합성/건성 피부),27000,19900,999,7100,26.3,727
루치펠로,[단독기획] 루치펠로 7도 칫솔 8입 세트 (치약25g 추가 증정),29900,19900,635,10000,33.4,728
에뛰드,에뛰드 플레이 톤 아이 팔레트,30000,19900,999,10100,33.7,729
비레디,비레디 블루쿠션 SPF 34 PA++/15g (본품/리필 택1),29000,19900,999,9100,31.4,730
일리윤,[1월 올영픽] 일리윤 MD 레드이치 크림 330ML 기획(오일 20ML 증정),26000,19900,999,6100,23.5,731
덴티스테,덴티스테 마일드 나이트타임 치약 160g 2종(4입/12입) 택1,65900,39500,56,26400,40.1,732
비타바움,비타바움 12병입 2종 중 택1 (비타민B12플러스/멀티비타민 플러스),49000,39500,481,9500,19.4,733
바닐라코,바닐라코 커버리셔스 파워 핏 파운데이션 30ml / 6colors,34000,27200,999,6800,20.0,734
메디힐,[선우PICK] 메디힐 티트리 진정 수분 앰플 50ml+18ml 증정 기획,32000,19800,999,12200,38.1,735
필리밀리,필리밀리 괄사 모음(브이페이스/세라믹바디/페이스&바디/듀얼미니괄사),17000,15900,999,1100,6.5,736
피지오겔,피지오겔 레드수딩 AI 진정보습 로션 200ml,37500,27000,999,10500,28.0,737
아이소이,"아이소이 속보습, 100시간 장수진 수분크림 70ml 기획(+수분앰플 10ml)",36000,27000,999,9000,25.0,738
프레스샷,[1월 올영픽]프레스샷 올인원 토탈 영양 앰플 10개입 (10일분),29900,26900,999,3000,10.0,739
프로에잇,[NEW 뮤트브라운 컬러 추가] 프로에잇 스테이 온 젤 아이라이너+듀얼 아이라이너 브러쉬 기획세트,35000,26900,338,8100,23.1,740
로우퀘스트,로우퀘스트 베리어 리커버리 크림 80ml,38000,26900,3,11100,29.2,741
바이오더마,바이오더마 아토덤 울트라 크림 200ml,28000,19600,705,8400,30.0,742
닥터디퍼런트,닥터디퍼런트 비타리프트 에이 포르테 20g,52000,39000,999,13000,25.0,743
바닐라코,바닐라코 커버리셔스 스킨 핏 틴티드 모이스처라이저 30ml,25000,19400,999,5600,22.4,744
아임프롬,[셔누 PICK]아임프롬 허니 마스크 120g 기획 (+ 피그 스크럽 30g 증정 단독기획),38000,26600,999,11400,30.0,745
코스알엑스,코스알엑스 풀핏 프로폴리스 라이트 앰플 40ml 더블 기획(+시트마스크 1매 증정),50000,26500,999,23500,47.0,746
퓌,퓌 파운데이션 글래스 4color,32000,19200,999,12800,40.0,747
투쿨포스쿨,투쿨포스쿨 피니쉬 세팅 팩트,16000,14400,999,1600,10.0,748
힌스,힌스 뉴 뎁스 아이섀도우,18000,14400,999,3600,20.0,749
아이소이,[응급진정패드] 아이소이 아크니닥터 1st 스팟 패드 60매,23800,19000,828,4800,20.2,750
필리밀리,[NEW] 필리밀리S 결점커버컨실러브러시812,12000,10830,222,1170,9.8,751
리무브,리무브 스킨브라 10종 택1,16500,14800,999,1700,10.3,752
바이탈뷰티,바이탈뷰티 메타그린 슬림업 14일 (2주분),19000,14200,476,4800,25.3,753
필리밀리,필리밀리 듀얼 메이크업 스파츌라,12000,10800,999,1200,10.0,754
메디힐,[헤어롤증정] 메디힐 티트리 진정 수분 앰플 50ml (빤쮸토끼 기획),32000,18900,999,13100,40.9,755
템포,템포 탐폰 2종 택 1 (레귤러 20P/ 슈퍼 20P),10500,7900,872,2600,24.8,756
라엘,"라엘 리얼라엘 내추럴 청결 티슈 3종 택 1 (10매, 30매, 30매*4팩)",2500,2300,999,200,8.0,757
코스알엑스,코스알엑스 더 비타민C23 세럼 더블기획 (+펩타이드세럼1.5ml*4ea),46000,32200,999,13800,30.0,758
리브러쉬,[2023 어워즈] 리브러쉬 클러브 농축가글 50ml 어워즈 한정기획(+20ml 증정),39800,25800,999,14000,35.2,759
바닐라코,[1등 클렌징밤]바닐라코 클린잇제로 클렌징 밤 오리지널 100ml,20000,14000,999,6000,30.0,760
플랙커스,플랙커스 마이크로민트 치실 (36개입/90개입),3700,3040,999,660,17.8,761
크리스탈 라이트​,크리스탈라이트 10+2P 기획 4종 중 택1,6500,4550,211,1950,30.0,762
달리프,달리프 워터트리트먼트 더블 기획 (200ml+200ml)(탈모증상완화),22000,18600,999,3400,15.5,763
로레알,로레알파리 엑셀랑스 블리치 슈프림 (탈색),20000,13900,649,6100,30.5,764
라운드랩,[NEW] 라운드랩 소나무 진정 시카 클렌저 150ml,17000,13900,280,3100,18.2,765
라운드랩,라운드랩 자작나무 수분크림 (본품80ml+20ml 추가 증정),32000,25600,999,6400,20.0,766
헤트라스,[1+1] 헤트라스 프리미엄 대용량 디퓨저 500ml 2개입 4종 택1,18900,18500,999,400,2.1,767
이브로쉐,[증량] 이브로쉐 헤어식초 400ml 2종 택 1 (라즈베리 / 모링가),17500,14500,999,3000,17.1,768
라보에이치,[대용량] 라보에이치 퍼퓸에디션 두피강화 샴푸 750ml [페어앤프리지아/블랑쉬앤우디] 택1,36000,25400,999,10600,29.4,769
파티온,파티온 노스카나인 트러블 클리어 토너 200ml,23000,18400,999,4600,20.0,770
달리프,[앞머리&볼륨고정] 달리프 헤어픽서200ml(+컬크림+폴리쉬오일) 증정기획,16000,10400,999,5600,35.0,771
미팩토리,미팩토리 1단 돼지코팩 10매입,8900,7900,999,1000,11.2,772
오울루,버치 아토 모이스처 크림 더블세트,80000,60000,41,20000,25.0,773
3CE,3CE 스킨 핏 커버 리퀴드 컨실러,17000,13600,239,3400,20.0,774
스킨푸드,[당근패드] 스킨푸드 캐롯 카로틴 카밍 워터 패드 60매,26000,18200,999,7800,30.0,775
바이탈뷰티,[7일+1일/피부기능성]바이탈뷰티 슈퍼콜라겐 기획세트,25000,18200,999,6800,27.2,776
넥스케어,[어워즈 한정] 넥스케어 이지픽 블레미쉬 패치 릴리프 더블 기획 (68매+68매),8600,7740,999,860,10.0,777
피지오겔,[더블기획] 피지오겔 레드수딩 시카밸런스 크림 50ml+50ml 증정 기획,30000,25000,999,5000,16.7,778
메디앤서,[대용량] 메디앤서 비타 콜라겐 마스크 10매,60000,24900,999,35100,58.5,779
에스테덤,[광채미스트]에스테덤 씨티 프로텍트 미스트 100ml,69000,59340,61,9660,14.0,780
필리밀리,[나겸쌤 공동개발] 필리밀리S 밀착플랫파운데이션브러시826,20000,17960,165,2040,10.2,781
유기농본,유기농본생리대 오버나이트10p,5800,4200,999,1600,27.6,782
썸블라썸,썸블라썸 시카 케어 바디 미스트 300ml,14700,13200,999,1500,10.2,783
듀이트리,[잡티케어]듀이트리 AC컨트롤 EX 딥 흔적 진정 마스크 1+1 기획,3000,2850,999,150,5.0,784
닥터지,[2세대 천만크림] 레드블레미쉬 클리어 수딩 크림 트리오 세트(50ml 3개입),42000,35900,409,6100,14.5,785
일리윤,[재구매1위]일리윤 세라마이드 아토 집중크림 150ml,13900,9900,999,4000,28.8,786
바이오힐보,바이오힐보 비타민 토닝 올멜팅 클렌징밤 95mL,20000,9900,999,10100,50.5,787
달바,[845만개 판매] 달바 워터풀 마일드 선크림 듀오 기획 (50ml+50ml),51000,35700,999,15300,30.0,788
에스쁘아,에스쁘아 꾸뛰르 립틴트 블러벨벳 5.5g 8 colors,22000,17600,999,4400,20.0,789
필리밀리,필리밀리 히팅뷰러 건전지 타입,22900,17600,533,5300,23.1,790
다슈,다슈 포맨 밤부 포레스트 메가 하드 스프레이 180ml,15000,9800,999,5200,34.7,791
바이오힐보,바이오힐보 비타민 히알루로닉 젤크림 70mL 기획 (크림 30mL 증정),25000,17500,999,7500,30.0,792
마녀공장,[대용량] 마녀공장 갈락 필링젤 용량 UP 120ml X2 더블 기획,35000,17500,999,17500,50.0,793
플리프,플리프 시카-알로에 프레쉬 수분크림 150ml 기획세트(+50ml 증정),21000,17500,549,3500,16.7,794
토리든,[단독증량기획] 토리든 다이브인 무기자차 마일드 선크림 60ml 기획 (+20ml 추가 증정),25000,17500,999,7500,30.0,795
뉴오리진,뉴오리진 이너플로라 30캡슐 (30일분),36000,24200,218,11800,32.8,796
라운드랩,라운드랩 1025 독도 크림 (본품 80ml+20ml 추가 증정),32000,24000,999,8000,25.0,797
에스트라,에스트라 아토베리어365 바디크림 250ml,30000,24000,785,6000,20.0,798
한율,한율 어린쑥 진정 맑은 클렌징폼 기획세트 (폼120g + 수분진정크림15g),16000,12800,999,3200,20.0,799
에뛰드,[NEW컬러] 에뛰드 플레이 컬러 아이즈 쿨 스테이지,30000,23900,999,6100,20.3,800
CKD,[대용량] CKD 레티노콜라겐 저분자 300 모공탄력 마스크 10매,50000,23900,999,26100,52.2,801
브리스킨,[은현 PICK]브리스킨 어성초 엑소펩타이드 콜라겐 마스크 5매,50000,35000,195,15000,30.0,802
달바,[올영 단독 증정/톤업자차] 달바 워터풀 톤업 선크림 50ml,34000,23800,999,10200,30.0,803
베네피트,베네피트 원더풀 월드 블러쉬 & BOP 미니 5종 택1 (단델리온 외),28000,23800,999,4200,15.0,804
넘버즈인,[수분광채] 넘버즈인 6번 푹잠 마스크팩 세럼 80ml 기획(+4번 SOS 얼음장팩),34000,23800,999,10200,30.0,805
비레디,[2023 어워즈]  비레디 트루 톤 로션 33ml 리필 어워즈 한정기획 (본품+리필),49900,34900,467,15000,30.1,806
브링그린,[온라인 단독기획]브링그린 프레시마스크 10매 기획 5종,16000,9500,999,6500,40.6,807
이즈앤트리,[디렉터파이추천] 이즈앤트리 어니언 뉴페어 클렌징폼 150ml,18000,12600,999,5400,30.0,808
메디힐,메디힐 더 N.M.F 앰플 마스크 1매,3000,1500,999,1500,50.0,809
제니하우스,[1+1 한정기획] 제니하우스 프리미엄 헤어컬러 1+1 기획 4종 택1,16000,12500,999,3500,21.9,810
그린몬스터,그린몬스터 이너블라썸 질 유래 여성유산균 30캡슐 (1개월분),25200,16900,741,8300,32.9,811
바이오힐보,바이오힐보 프로바이오덤 타이트닝 콜라겐 세럼 30mL 더블 기획,57000,34500,999,22500,39.5,812
바이오힐보,[NEW] 바이오힐보 판테셀 리페어시카 크림 50mL+50mL 기획,57600,34500,999,23100,40.1,813
순백수,순백수 히노끼 디퓨저 150ml 3종 택1(리프/우드/로즈),23900,16830,598,7070,29.6,814
듀이트리,[더보이즈큐포카&다꾸템증정]듀이트리 AC컨트롤 EX 딥 그린 카밍 패드 60매기획(+20매 증정),24000,16800,999,7200,30.0,815
아비브,[1월 올영픽] 아비브 수분초 히알루론 패드 하이드레이팅 터치 75매 기획 (+10매 추가 증정),24000,16800,999,7200,30.0,816
그로우어스,그로우어스 데미지 테라피 노워시 트리트먼트 250ml 기획(+크림트리트먼트 21ml 증정),26000,23200,999,2800,10.8,817
유즈,유즈 스테이포에버 퍼퓸 002 30ml,39000,34100,498,4900,12.6,818
아벤느,아벤느 이드랑스 딥모이스트 로션 200ml 더블 기획,40500,34100,925,6400,15.8,819
템포,템포 레귤러/슈퍼 10P 2종 택 1,6200,4800,999,1400,22.6,820
니드인,[2023어워즈/한정기획] 니드인 비움효소 3g 10포+10포 증정기획,25000,22900,999,2100,8.4,821
힐링배스,힐링배스 시원한 그레이 샤워타월,2500,2250,999,250,10.0,822
아리아나그란데,아리아나그란데 스위트 라이크 캔디 EDP  50ml,85000,55200,553,29800,35.1,823
바이오더마,바이오더마 아토덤 PP밤 500ml,48000,33600,999,14400,30.0,824
아누아,[단독기획] 아누아 어성초 80 수분 진정 앰플 기획 (30ml+30ml),46000,33600,999,12400,27.0,825
루나,[다크서클컨실러] 루나 컨실 팟 4colors,15000,12000,999,3000,20.0,826
디어에이,[민카롱PICK][미니퍼프 2P 사은품 추가증정] 디어에이 퍼펙트 커버 컨실러 팔레트 퍼프기획 3종,16000,12000,336,4000,25.0,827
꾸미,릴크리터스 꾸미바이트 비타민 3종 택1 (비타민/칼슘/아연) (30일분),15000,12000,175,3000,20.0,828
리엔,리엔 흑모비책 오리엔탈 새치크림 염색 더블 기획,12900,11900,999,1000,7.8,829
이브,이브 핑거돔 18P (공산품),12900,11900,572,1000,7.8,830
샤이샤이샤이,[NEW] 샤이샤이샤이 선 키스드 플럼프 립밤 4g 3종 중 택 1,15000,11900,3,3100,20.7,831
풀리오,풀리오 종아리 마사지기 지퍼형,129000,119000,186,10000,7.8,832
트리헛,[단독기획] 트리헛 시어 슈가 스크럽 더블기획 3종 택1 (510g+510g),39500,33300,999,6200,15.7,833
누즈,[NEW/블러셔]누즈 리퀴드 케어 치크,19000,16150,383,2850,15.0,834
컬러그램,[NEW] 컬러그램 썬더볼 틴트 라커 6color,9800,8800,999,1000,10.2,835
더블유드레스룸,[2023 어워즈]W.DRESSROOM 퍼퓸 핸드크림 에이프릴코튼 50ml+50ml 어워즈 더블 기획팩 (2023),7900,6500,999,1400,17.7,836
파파레서피,파파레서피 블레미쉬 클렌징 오일 300ml,25000,22500,26,2500,10.0,837
마르시끄,[2023 어워즈/브라이언 PICK] 마르시끄 링클 리페어 미간 주름패치 33개,12900,11800,999,1100,8.5,838
루톤,루톤 여성 두피용 알파에르겐 트리트먼트 500ml+트리트먼트 70ml 증정 기획,27000,22400,999,4600,17.0,839
파티온,[홀리 공동개발] 파티온 노스카나인 트러블 흔적앰플 15ml,20000,16000,999,4000,20.0,840
반디,[다영PICK] 반디 핑크다이아기획 & 뿌리세럼 골라담기,20000,16000,999,4000,20.0,841
센카,센카 퍼펙트 휩 포 바디 500ml,10900,8700,999,2200,20.2,842
청담소녀,"청담소녀 생리대 5종 택 1 (생리대, 라이너, 오버나이트)",7400,5600,832,1800,24.3,843
세타필,"세타필 젠틀 바디워시 리프레싱 1,000ml",26500,15900,953,10600,40.0,844
박준뷰티랩,[대용량]박준뷰티랩 LPP 단백질 샴푸 1000ml,17600,15800,999,1800,10.2,845
커리쉴,[한정기획]커리쉴 에프터살롱케어 데미지리페어 샴푸 500ml 기획(+트리트먼트 160ml 증정),26000,22000,999,4000,15.4,846
유리아쥬,유리아쥬 진피 마일드 젤 500ml,36000,32400,999,3600,10.0,847
나인위시스,[리뷰이벤트/권은비 PICK] 나인위시스 하이드라 수분 앰플 나노 플러스 30ml 더블기획,24500,21900,999,2600,10.6,848
메디앤서,[미백탄력] 메디앤서 비타 콜라겐 마스크 1매,6000,3000,999,3000,50.0,849
오킵스,오킵스 워킹핸즈 핸드크림 튜브 85g,13000,8300,992,4700,36.2,850
필리밀리,필리밀리 촉촉퍼프,5000,4300,999,700,14.0,851
비오템 옴므,비오템옴므 아쿠아파워 올인원 세트 (클렌저40ml+올인원20ml),62000,52700,795,9300,15.0,852
바이오힐보,[리뷰이벤트/NEW] 바이오힐보 프로바이오덤 3D 리프팅 크림 50ml,39000,31900,23,7100,18.2,853
리얼테크닉스,리얼테크닉스 미라클 컴플렉션 스펀지 3종 택1,13500,10800,999,2700,20.0,854
레미유,[NEW 컬러] 레미유 듀이 플로우 틴트,19000,15200,999,3800,20.0,855
바이오힐보,[NEW] 바이오힐보 판테셀 리페어시카 크림 50mL,32000,21380,999,10620,33.2,856
샤프란,샤프란케어 냄새뺌 비누향/코튼향 2종 택1,9400,5900,999,3500,37.2,857
식물나라,식물나라 제주탄산수퀵앤딥클렌징티슈 100매,8800,5900,999,2900,33.0,858
몰바니,[고민시 PICK]몰바니 저자극 LHA 율피 젤 클렌저 200ml,28000,21280,904,6720,24.0,859
나이팅게일,나이팅게일 데일리더마 클렌징패드 마일드 (70매),12500,11000,999,1500,12.0,860
메이크프렘,[증량] 메이크프렘 세이프 미 릴리프 모이스처 클렌징 밀크 500ml,42000,31500,728,10500,25.0,861
쏘내추럴,쏘내추럴 올 데이 메이크업 픽서 더블기획 (120ml+120ml),42000,31500,999,10500,25.0,862
맥,MAC 텐더토크 립 밤,37000,31450,206,5550,15.0,863
릴리바이레드,릴리바이레드 스키니메스 브로우 마스카라,10000,8000,999,2000,20.0,864
대웅제약,대웅제약 에너씨슬 콜레다운 30캡슐 (1개월분),17500,15000,626,2500,14.3,865
피지오겔,[더블기획] 피지오겔 DMT 마일드 립밤 4.2g+4.2g 기획세트,19800,15000,999,4800,24.2,866
바이오힐보,[NEW] 바이오힐보 세라마이드 아쿠아 토닝 필링 젤 120mL 기획 (60mL 증정),18000,10900,423,7100,39.4,867
락토핏,락토핏 이브 30포 (15일분),14900,10900,467,4000,26.8,868
락토핏,락토핏 슬림 30포 (15일분),14900,10900,999,4000,26.8,869
브링그린,[NEW] 브링그린 쑥세라카밍모이스처약산성클렌징폼200mL더블기획,22800,14900,318,7900,34.6,870
로레알,[기획세트]로레알파리 토탈리페어5 트리트먼트 헤어팩,21500,14900,999,6600,30.7,871
메이크프렘,메이크프렘 유브이 디펜스 미 노 세범 선크림 40ml 1+1 기획,28000,21000,999,7000,25.0,872
닥터텅스,닥터텅스 구역질없는 혀클리너(파우치 증정)(색상 랜덤),10000,7900,999,2100,21.0,873
필리밀리,필리밀리 뿌리 볼륨 브러시,8500,7900,999,600,7.1,874
미쟝센,[NEW] 미쟝센 컬링에센스 2X 볼륨컬/내추럴컬 230ml 택1,15000,7900,999,7100,47.3,875
디어에이,디어에이 루미너스 네일 에센스 3g,10900,7900,722,3000,27.5,876
바닐라코,바닐라코 촘촘 카스텔라 퍼프 6EA,5000,4000,999,1000,20.0,877
바닐라코,바닐라코 프라이머 피니쉬 팩트 6.5g,26000,20800,999,5200,20.0,878
아로마티카,[강민경 PICK] 아로마티카 바디오일 100ml 리츄얼 기획(괄사 포함) 5종 택1,44000,30800,999,13200,30.0,879
코링코,코링코 톡톡하라 필터 속눈썹 블랙/브라운 200pcs (9mm/10mm/11mm/12mm),20000,13210,999,6790,34.0,880
린제이,린제이 진정약초 모델링 마스크 컵팩 28g,3000,2500,999,500,16.7,881
비오템 옴므,비오템 옴므 아쿠아파워 72H 수분 젤 크림 50ml,130000,110500,46,19500,15.0,882
누즈,[NEW]누즈 케어 립추얼,17000,14450,999,2550,15.0,883
글린트,[NEW 컬러출시] 글린트 스틱하이라이터,24000,20400,999,3600,15.0,884
모로칸오일,모로칸오일 인텐스 컬 크림 75ml,16000,14400,999,1600,10.0,885
키스미,[픽싱 젤 브로우] 키스미 헤비로테이션 젤 아이브로우 라이너,13000,10400,999,2600,20.0,886
토니모리,[NEW] 토니모리 겟잇틴트 컬러풀워터 5종,13000,10400,501,2600,20.0,887
헤드앤숄더,헤드앤숄더 가려운 두피케어 샴푸 500ml 더블 기획,17300,10400,999,6900,39.9,888
투쿨포스쿨,투쿨포스쿨 피니쉬 세팅 오일 페이퍼 (본품+리필),8500,7500,999,1000,11.8,889
스튜디오17,스튜디오17 아이메이크업 브러쉬 세트 (5종),12900,10320,999,2580,20.0,890
포지타노,포지타노 캔디 4종 중 택1,8900,7400,999,1500,16.9,891
바이오힐보,[NEW] 바이오힐보 프로바이오덤 타이트닝 콜라겐 크림 50mL 기획 (앰플 7mL*2 증정),38000,29900,509,8100,21.3,892
웨이크메이크,[시즌한정컬러] 웨이크메이크 네일건 홀리데이 시즌 네일 6 COLOR,4000,3600,435,400,10.0,893
이브,[의료기기] 이브 콘돔 2종 택 1 (리얼003 10P / 울트라씬 10P),13900,12900,721,1000,7.2,894
아로마티카,[쿨링젤] 아로마티카 수딩 알로에 베라 젤 (300ml/500ml),11000,8800,999,2200,20.0,895
니베아,니베아 크림150ml,6500,5200,999,1300,20.0,896
쉬크,쉬크 인튜이션 버라이어티 기획 5종 택1 (기+날4입),24900,19900,999,5000,20.1,897
딥트3일,"[주현영, 이나연 찐템]딥트 3일 분해효소 리셋 8포 (8일분)",21000,13970,515,7030,33.5,898
닥터블릿,[혜리PICK] 닥터블릿 푸응 다이어트14포 (7일분),22900,13970,687,8930,39.0,899
히든,히든 퍼퓸 스프레이 바디로션 단품/기획 5종,32900,29600,410,3300,10.0,900
마몽드,[윈터 PICK] 마몽드 포어 슈링커 바쿠치올 크림 60ml 단독기획 (+30ml 추가증정),38000,29600,406,8400,22.1,901
비타하임,비타하임 칼슘+마그네슘+비타민D 15정(15일),5000,3500,999,1500,30.0,902
듀이셀,듀이셀 마스크팩 5P,33000,19800,999,13200,40.0,903
웰라쥬,[형원PICK] 웰라쥬 리얼 히알루로닉 원데이키트 7개입,39700,19800,999,19900,50.1,904
구달,[한정기획] 구달 맑은 어성초 진정 쿨링 선스틱 1+1 기획 SPF50+ PA++++,22000,19800,748,2200,10.0,905
비욘드,[NEW] 비욘드 엔젤아쿠아 수분가득 진정 앰플 50ml 1+1 기획,28000,19800,201,8200,29.3,906
라보에이치,라보에이치 탈모증상완화 샴푸 두피쿨링 (333ml+50ml),19800,13900,999,5900,29.8,907
마녀공장,[후니언 Pick] 마녀공장 딥 클리어 클렌징 밤 기획(132ml+14ml),24000,13900,999,10100,42.1,908
바이오힐보,바이오힐보 비타민 히알루로닉 앰플토너 150mL & 에멀전 150mL 기획 (크림30mL 증정),42000,29400,999,12600,30.0,909
닥터지,[증정]닥터지 로얄 블랙스네일 크림세트(50ml+15ml),42000,29400,613,12600,30.0,910
아로마코,아로마코 허브디퓨저_포레스트,17000,9900,999,7100,41.8,911
뉴트로지나,뉴트로지나 인텐스 리페어 풋크림 56g (뒤꿈치 관리),8900,7100,999,1800,20.2,912
나인위시스,[리뷰이벤트/단독 기획] 나인위시스 하이드라 크림 앰플 더블 기획 (30ml+30ml),21900,19500,999,2400,11.0,913
스킨푸드,[NEW/수분진정] 스킨푸드 캐롯 카로틴 데일리 마스크 30매,26000,19500,4,6500,25.0,914
바이탈헬스,바이탈헬스 바이탈슬림 다이어트 올인원 나이트 10포 (10일분),16000,9810,838,6190,38.7,915
허스텔러,[스칼렛언니 PICK] 허스텔러 니어바이 리차징 립밤 6종 중 택1,14000,9100,999,4900,35.0,916
라엘,라엘 입는 오버나이트 8P 2종 택1 (M/L),12900,9800,92,3100,24.0,917
센카,[츄PICK] 센카 퍼펙트 휩 페이셜 워시 120g,9800,7020,999,2780,28.4,918
브링그린,[2023 어워즈] 브링그린 티트리시카  수딩 토너 500ml 어워즈 한정기획(+크림20ml+징크테카세럼 7ml),27000,19440,999,7560,28.0,919
아임오,아임오 유기농 생리대 4종 택 1 (소 12P / 중 14P / 대 9P / 오버나이트 6P ),4500,3300,451,1200,26.7,920
그린몬스터,[단독기획] 그린몬스터 식전식후 바디관리세트 (28일분),35000,28900,999,6100,17.4,921
버츠비,버츠비 임산부 기프트 기획 (마마비 벨리버터 185g+마마비 너리싱 바디오일 147ml),34000,28900,999,5100,15.0,922
더파이에센셜,[디렉터파이 MADE] 더파이 시카알란 퍼스트 에센스 150ml,34000,28900,332,5100,15.0,923
VDL,VDL 커버 스테인 퍼펙팅 쿠션 리필 기획,34000,28900,471,5100,15.0,924
화이트,화이트 순한순면 생리대 4종 택 1 (중형 / 대형 / 수퍼롱 / 오버나이트),7100,3910,999,3190,44.9,925
페리페라,페리페라 더블롱웨어 커버컨실러,6000,4800,999,1200,20.0,926
노베브,[재유 공동개발] 노베브 언더 아이 컨실러 2colors (웜/쿨톤),14000,13300,305,700,5.0,927
에스더포뮬러,[1등이너뷰티]에스더포뮬러 여에스더 글루타치온 다이렉트 필름 3X 30매 (30일분),38000,28400,259,9600,25.3,928
에스네이처,[화해1위] 에스네이처 아쿠아 오아시스 토너 300ml 기획(+ 수분크림30ml증정),24000,18900,999,5100,21.2,929
피토틱스,피토틱스 옐로우 30캡슐 (1개월분),19500,18900,999,600,3.1,930
버터크룽지,"버터크룽지 10개입 2종 중 택1(오리지날, 초코디핑)",23000,18900,8,4100,17.8,931
필리밀리,필리밀리 미니메이크업브러시세트(2309 한정기획),23000,18800,999,4200,18.3,932
좋은느낌,[대용량] 좋은느낌 입는 오버나이트 5종 택 1 (S / M / L),17600,7920,580,9680,55.0,933
바이오더마,[온라인 단독기획] 바이오더마 하이드라비오 에센스로션 더블기획(200ml+200ml),54000,46900,999,7100,13.1,934
네이처메이드,네이처메이드 액티브 데일리 멀티 포 맨 120정 (2개월분),35000,28000,999,7000,20.0,935
스틸라,스틸라 매그니피센트 메탈 글리터&글로우 리퀴드 아이섀도우,35000,28000,999,7000,20.0,936
덴탈프로,덴탈프로 치간칫솔 사이즈 0번 15P,6500,4500,999,2000,30.8,937
쏘피,[올리브영 단독] 쏘피 X 벨리곰 안심숙면 팬티 5P 2종 택 1(입는오버나이트),9000,4500,999,4500,50.0,938
바디홀릭,바디홀릭 스테이누디 헤어&바디 미스트 100ml 3종 택1,15900,12900,999,3000,18.9,939
비판톨,비판톨 립크림 더블 기획 (7.5ml+7.5ml ),14400,12900,999,1500,10.4,940
쉬크,쉬크 인튜이션 잔망루피에디션 제모기 2종 택1(기+날1입),15900,12900,999,3000,18.9,941
더랩바이블랑두,더랩바이블랑두 그린 플라보노이드 진정 패드(90매+12매 추가 증정),23000,18400,999,4600,20.0,942
스튜디오17,스튜디오17 팡팡 대왕 퍼프,5900,4410,999,1490,25.3,943
키스미,[2mm 부드러운 젤펜슬] 키스미 히로인메이크 롱 스테이 스무스 젤 펜슬 라이너,12000,9000,999,3000,25.0,944
이니스프리,이니스프리 노세범 AC 파우더 5g,12000,9000,506,3000,25.0,945
라네즈,[1월올영PICK/선착순워터뱅크4종키트] 라네즈 워터뱅크 모이스춰 크림 45ml 배드블루 콜라보 기획,39000,27500,52,11500,29.5,946
롱테이크,롱테이크 핸드크림 50ml 2종 [샌달우드/블랙티앤피그] 택1,18000,12600,318,5400,30.0,947
린제이,린제이 엄청 큰 보습 멀티 앰플 (500ml),9900,8900,457,1000,10.1,948
셀퓨전씨,[진정쿨링] 셀퓨전씨 포스트 알파 시카 쿨링 마스크 1매,3000,1500,999,1500,50.0,949
라운드랩,[NEW] 라운드랩 약콩 판테놀 마스크 1매,3000,1500,994,1500,50.0,950
아리아나그란데,아리아나그란데 클라우드 EDP 30ml,67000,45600,237,21400,31.9,951
랩노쉬,[패키지 리뉴얼]랩노쉬 프로틴 단백쿠키 7종 택1 (10개입),13900,12510,255,1390,10.0,952
아도르,[카즈하 PICK] 아도르 퍼퓸 헤어 오일 80ml 4종 택 1,32000,27200,999,4800,15.0,953
메이크프렘,메이크프렘 세이프 미 릴리프 모이스처 클렌징오일 기획(210ml+20ml),24000,18000,721,6000,25.0,954
듀이트리,[더보이즈큐포카&다꾸템증정]듀이트리 AC 컨트롤 딥 그린 카밍 크림 기획(60ml+20ml증정),28000,18000,241,10000,35.7,955
라운드어라운드,라운드어라운드 편백 블레미쉬 클렌징폼 200ml+200ml 더블 기획세트,31000,18000,999,13000,41.9,956
잇츠스킨,잇츠스킨 파워10 포뮬라 엘아이 젤리패드 감초줄렌 70매 기획 (+10매),25000,18000,999,7000,28.0,957
넘버즈인,[각질7층보습] 넘버즈인 4번 메이크업 찰떡 미네랄 토너 200ml 기획 (+50ml 증정),24000,18000,353,6000,25.0,958
미언더,미언더 시그니처 나무팬티 드로즈_6color,23000,18000,25,5000,21.7,959
BYOCORE유산균,[이동욱 PICK] CJ BYOCORE 건강한 생유산균 100억 30포 (1개월분),29900,17940,272,11960,40.0,960
에스네이처,[2023어워즈] 에스네이처 아쿠아 스쿠알란 수분크림 60ml,24000,17900,999,6100,25.4,961
라운드랩,라운드랩 1025 독도 클렌징 오일 200ml (클렌저40ml 증정),23000,17900,999,5100,22.2,962
모레모,[1월 올영픽]모레모 헤어샴푸 미라클 2X 480ml 기획(100ml 증정),26000,17900,741,8100,31.2,963
라운드랩,[NEW] 라운드랩 포 맨 1025 독도 올인원 플루이드 200ml,24000,17900,731,6100,25.4,964
티르티르 이너뷰티,티르티르 퍼펙트 아르기닌 피치 5000 15포 (15일분),21000,17850,66,3150,15.0,965
팬틴,팬틴 실키 스무드케어 린스 500ml,12300,6100,999,6200,50.4,966
더마토리,더마토리 프로 앰플 마스크 1매 [수분/탄력/미백/진정] 4종 중 택1,2000,1000,999,1000,50.0,967
피지오겔,피지오겔 DMT 바디로션 400ml,33500,26900,999,6600,19.7,968
헉슬리,[NEW 컬러 출시] 헉슬리 립밤 리브 비하인드 6종 중 택 1,14000,11900,999,2100,15.0,969
어네이즈,어네이즈 잔머리카라 8ml,13000,12300,999,700,5.4,970
마녀공장,[증정기획] 마녀공장 비피다 바이옴 앰플 토너 400ml+100ml 기획,25000,17500,999,7500,30.0,971
라타플랑,라타플랑 미나리 진정 선크림 기획세트 (50ml+20ml 증정),25000,17500,962,7500,30.0,972
리무브,리무브 스킨브라 더블기획 2종 택1,33000,26400,999,6600,20.0,973
로이비,로이비 로터스 앤 인센스 EDP 50ml,109000,98100,56,10900,10.0,974
에비스,에비스 프리미엄케어 6열 광폭헤드 칫솔 미세모 (색상랜덤),4600,3900,999,700,15.2,975
필리밀리,필리밀리 양면 쌍꺼풀 테이프,2800,2400,999,400,14.3,976
존슨즈,[하니얌Pick] 존슨즈베이비 베드타임 오일 500ml,18900,11900,50,7000,37.0,977
덴티스테,덴티스테 치실50m,4900,3800,999,1100,22.4,978
아로마티카,[1+1기획] 아로마티카 로즈마리 루트 인핸서 100ml+100ml 더블 기획,24000,17100,999,6900,28.7,979
필리밀리,필리밀리 코 쉐딩브러시 857,9500,8200,999,1300,13.7,980
닥터지,닥터지 약산성 레드 블레미쉬 클리어 수딩 폼 기획 (150ml+75ml),20000,17000,999,3000,15.0,981
플루,[스푼증정기획] 플루 리얼슈가&씨솔트 퍼퓸드 바디스크럽 500g 6종 택1,22000,16900,999,5100,23.2,982
CKD,[은또PICK/단독기획] CKD 레티노콜라겐 저분자 300 타이트닝 물광 크림팩 브러쉬 기획,28000,16900,710,11100,39.6,983
한율,한율 어린쑥 수분진정 랩핑 마스크 1매,4000,2200,456,1800,45.0,984
달바,[100시간 보습/겉광속쫀] 달바 화이트 트러플 더블 레이어 리바이탈라이징 세럼 30ml,72000,43200,593,28800,40.0,985
라로슈포제,라로슈포제 히알루B5 세럼 30ml 기획 (+똘러리앙로션 15ml),54000,43200,949,10800,20.0,986
아임프롬,[셔누 PICK]아임프롬 피그 스크럽 마스크120g 기획(+허니마스크 30g),32000,25600,999,6400,20.0,987
피노,피노 프리미엄 터치 헤어 오일 70ml+70ml 더블기획(졸리지 콜라보 굿즈 증정),32000,25600,389,6400,20.0,988
페리페라,[페리복권] 페리페라 올테이크무드팔레트,21000,16800,999,4200,20.0,989
스킨푸드,[비건/유기자차] 스킨푸드 베리 수분 선크림 50ml SPF50+ PA++++,24000,16800,362,7200,30.0,990
넘버즈인,[피부결] 넘버즈인 3번 녹차숯 모공말끔 클렌징팩밤 85g,24000,16800,875,7200,30.0,991
토리든,[단독기획] 토리든 밸런스풀 시카 진정 크림 80ml 기획 (+세럼 10ml),24000,16800,999,7200,30.0,992
클리오,클리오 하이드로 메이크업 스펀지 오리지널 엣지,10000,8000,408,2000,20.0,993
마몽드,[단독기획] 마몽드 블루 캐모마일 크림 기획 60ml (+30ml 추가 증정),34000,25500,999,8500,25.0,994
폴라초이스,폴라초이스 스킨퍼펙팅 바하 리퀴드 각질제거제 118ml 기획 (+아하 각질제거 로션 10ml),34000,25500,60,8500,25.0,995
푸푸리,푸푸리 라벤더 바닐라 1.4 oz,9900,7900,999,2000,20.2,996
바디판타지,바디판타지 퓨어 프래그런스 바디 스프레이 5종 택 1,10000,7900,999,2100,21.0,997
쏘피,[단독기획] 쏘피 라베르플랑 라이너 롱 40P+40P기획 (80P),15800,7900,856,7900,50.0,998
갸스비,갸스비 필름 타입 기름종이 70매,3900,3500,999,400,10.3,999
유리아쥬,유리아쥬 오떼르말 더블 기획 (300ml+300ml),31500,25200,999,6300,20.0,1000
투쿨포스쿨,투쿨포스쿨 픽싱 글로우 쿠션 (본품+리필),36000,25200,999,10800,30.0,1001
달바,[올인원 간편스틱] 달바 더블 세럼 올인원 멀티밤 10g,42000,25200,458,16800,40.0,1002
투쿨포스쿨,[레오제이 공동개발] 투쿨포스쿨 픽싱 누드 쿠션 (본품+리필+미니쿠션 OY단독기획),36000,25200,999,10800,30.0,1003
더마비,[대용량] 더마비 데일리 모이스처 바디오일 300ml,24500,16500,523,8000,32.7,1004
닥터지,[NEW] 닥터지 로얄 블랙 스네일 앰플 마스크 1매,4000,2000,999,2000,50.0,1005
탱글티저,탱글티저 오리지널 미니 4종 택1,14000,10500,999,3500,25.0,1006
메디힐,메디힐 캡슐100 바이오 세컨덤 수분 하이드로 10매입,50000,25000,743,25000,50.0,1007
얼라이브,얼라이브 원스데일리 포 우먼 60정 (2개월분),30000,25000,999,5000,16.7,1008
디어스킨,디어스킨 에어엠보 4팩 6종 택 1(생리대/라이너/입는오버/슈퍼롱오버),28800,13900,340,14900,51.7,1009
달바,[쇼케이스 특가] 달바 워터풀 톤업 선 쿠션 듀오 기획(15g+15g),52500,42000,488,10500,20.0,1010
아크웰,[1+1]아크웰 피에이치 밸런싱 버블 프리 클렌징 젤 더블기획 (160ml+160ml),18000,16200,999,1800,10.0,1011
토리든,[단독기획] 토리든 밸런스풀 시카 토너 패드 60매 기획 (+10매 추가 증정),23000,16100,999,6900,30.0,1012
마른파이브,마른파이브 두프리 실리콘 누드브라 슬림,17900,16100,999,1800,10.1,1013
바이컬러,"[한혜진 PICK] 바이컬러 치약 3종 택1 (구취,미백,고불소)",10000,7500,999,2500,25.0,1014
뉴트리원라이프,뉴트리원라이프 루테인 지아잔틴 164 에이엑스 30캡슐 (1개월분),29900,16020,154,13880,46.4,1015
미쟝센,[2023 어워즈 헤어염색 1위] 미쟝센 헬로크림 1CB 쿨블랙 어워즈 한정기획 (+이너플렉스 모발강화제 30G),32000,16000,386,16000,50.0,1016
리스테린,리스테린 쿨민트 마일드 100ml (휴대용),2100,1800,268,300,14.3,1017
에뛰드,에뛰드 룩 앳 마이 아이즈 카페,4000,3200,999,800,20.0,1018
일리윤,일리윤 세라마이드 무향 립밤 더블 기획,23200,15900,999,7300,31.5,1019
로레알,로레알파리 UV 디펜더 선크림 50ml 4종 (데일리/톤업/오일프리/아쿠아),26000,15900,160,10100,38.8,1020
탱글엔젤,탱글엔젤 프로 브러쉬 4종 택1,29000,21900,999,7100,24.5,1021
콜게이트,콜게이트 맥시멈 캐비티 프로텍션 쿨민트 치약 100g,3900,3100,999,800,20.5,1022
화이트,[대용량] 화이트 순한순면 생리대 4팩 3종 택 1 (라이너 롱 40개입 / 일반 48개입 / 슬림중형 16개입),21800,11990,999,9810,45.0,1023
맥,MAC 락드 키스 24아워 립스틱,48000,40800,25,7200,15.0,1024
아이디얼포맨,아이디얼 포맨 퍼펙트올인원 탄력크림 기획세트 (퍼펙트 스킨 31ml 증정),30000,24000,999,6000,20.0,1025
뷰티리더,뷰티리더 스케치 아이브로우,6000,4800,999,1200,20.0,1026
피캄,피캄 베리어 사이클 락토P 토너 패드 60매,26500,23800,126,2700,10.2,1027
라운드어라운드,라운드어라운드 포레스트 센티드 바디 로션/워시 2종 택1,22000,15400,130,6600,30.0,1028
우르오스,우르오스 스킨로션 200ml,29700,23700,999,6000,20.2,1029
우르오스,우르오스 스킨밀크 200ml,29700,23700,999,6000,20.2,1030
라우쉬,라우쉬 컨디셔너 200ml 5종 택1 (스위스허벌/윌로우바크/콜츠푸트/아보카도/아마란스),26000,21500,590,4500,17.3,1031
르멘트,[NEW] [리뉴얼] 르멘트 반짝임 케어 다즐링 하드너 14ml,18000,15300,278,2700,15.0,1032
바비브라운,바비 브라운 엑스트라 립 틴트,47000,39950,999,7050,15.0,1033
라우쉬,라우쉬 오리지널 헤어 팅크처 200ml 기획 (힘없는 모근 모발),47000,39900,714,7100,15.1,1034
이지엔,NEW) 이지엔 하이라이트 헤어블리치 블랙빼기,9900,6930,59,2970,30.0,1035
라끌랑,라끌랑 쫀쫀밀착 비비옴므,26000,23400,186,2600,10.0,1036
마몽드,[리뷰이벤트/윈터 PICK] 마몽드 포어 슈링커 바쿠치올 패드 70매 기획 (+30ml 바쿠치올 크림 증정),26000,23400,5,2600,10.0,1037
릴리바이레드,[NEW] 릴리바이레드 스마일리 립 블렌딩 스틱 0.8g (온),12000,10200,32,1800,15.0,1038
자일리톨스톤,자일리톨스톤 70g 4종 택 1,7200,6500,259,700,9.7,1039
듀이트리,[더보이즈큐포카&다꾸템증정]듀이트리 AC컨트롤 딥 그린 카밍 클레이 젤 모공팩 100ml (패드10매 증정기획),21000,15120,642,5880,28.0,1040
브링그린,브링그린 징크테카1.2%흔적세럼25mL,22000,15010,999,6990,31.8,1041
더랩바이블랑두,더랩바이블랑두 그린 플라보노이드 씬진정 마스크팩 10매입,30000,15000,999,15000,50.0,1042
눅스,[1월올영픽/소의튜브PICK] 눅스 윌 프로디쥬스 멀티 플로럴 오일 100ml 기획 (+프리미엄 우드 괄사),52000,39500,500,12500,24.0,1043
에이프릴스킨,에이프릴스킨 초슬림 쿠션 (본품+리필 증정),33000,23100,137,9900,30.0,1044
인터미션,[고이진 PICK] 인터미션 레스트 업 세럼 스킨 200ml,27200,23100,512,4100,15.1,1045
프레스샷,프레스샷 올인원 토탈 영양 앰플 10입 / 20입 중 택 1),29900,26900,118,3000,10.0,1046
메디힐,메디힐 플라센타 에센셜 마스크 10매입,20000,10000,999,10000,50.0,1047
유기농본,유기농본 울트라날개 5종 택 1 (대형 / 중형 / 오버나이트),10600,7900,999,2700,25.5,1048
바티스트,바티스트 드라이샴푸 후레쉬 200ml,14500,9900,999,4600,31.7,1049
헬스헬퍼,맥스컷 버닝 400mg 60캡슐 (10일분),17800,9900,756,7900,44.4,1050
라우쉬,라우쉬 샴푸&컨디셔너 200ml 기획 4종 택1 (스위스허벌/윌로우바크/콜츠푸트/아보카도),39000,35100,123,3900,10.0,1051
닥터올가,닥터올가 프리미엄 선프로텍션 크림 60ml (톤업 선크림),38000,22800,173,15200,40.0,1052
브링그린,[백현 PICK] 브링그린 티트리시카트러블수딩토너패드 90매 (+90매 리필증정 기획),37800,22600,999,15200,40.2,1053
브링그린,[NEW] 브링그린 쑥세라카밍모이스처토너패드 90매 (+90매리필기획),37800,22600,527,15200,40.2,1054
우르오스,우르오스 스킨워시 500ml,18200,14500,999,3700,20.3,1055
바이오더마,바이오더마 아토덤 인텐시브 밤 500ml,48000,38400,999,9600,20.0,1056
달바,[아티스트 PICK] 달바 글로우 핏 세럼 커버 쿠션 15g,48000,38400,9,9600,20.0,1057
메디큐브,메디큐브 슈퍼시카 앰플 40ml,28000,22400,213,5600,20.0,1058
네이밍,네이밍 레이어드 매트 핏 쿠션 기획 (쿠션+프라이머 본품 증정),28000,22400,999,5600,20.0,1059
스킨푸드,[NEW] 스킨푸드 미나리 에센스 70ml,32000,22400,999,9600,30.0,1060
오센트,오센트 에어퍼퓸 250ml 리필 기획 2종 중 택 1 (포레스트/러브),30000,22300,999,7700,25.7,1061
닥터지,닥터지 레드 블레미쉬 포 맨 올인원 크림 150ml 기획세트(+30ml증정),29700,22200,999,7500,25.3,1062
버츠비,버츠비 틴티드 립밤 6 color,12000,7800,999,4200,35.0,1063
한율,[건성용]한율 부들밤 깔끔각질 모공팩 기획(+20ml +어린쑥폼32g),27000,22100,999,4900,18.1,1064
아크로패스,아크로패스 트러블큐어 36패치,39800,37800,999,2000,5.0,1065
라엘,라엘 무표백 순면 생리대 3종 택 1 (중형/대형/오버나이트),6400,5760,92,640,10.0,1066
락토덤,락토덤X위글위글 피부에 유익한 생보습 3종 기획,88000,21900,999,66100,75.1,1067
네어,네어 얼굴&비키니라인 제모 왁스스트립40매+피니싱티슈4매,17900,13900,926,4000,22.3,1068
마몽드,[재유 공동개발][모공브러쉬 증정] 마몽드 어메이징 딥 민트 클렌징밤 90ml 단독기획,27000,21600,222,5400,20.0,1069
비판톨,비판톨 데이케어 립스틱 4.5g 더블 기획 (꽃카 에디션),16200,13800,963,2400,14.8,1070
키스미,[마스카라 리무버] 키스미 히로인메이크 스피디 마스카라 전용 리무버,13000,9100,999,3900,30.0,1071
릴리바이레드,[NEW 러브콜에디션] 릴리바이레드 러브빔 블러 치크,13000,9100,999,3900,30.0,1072
테라로직,테라로직 레틴에이 안티 링클 3D 크림 20g+5g,48000,36900,281,11100,23.1,1073
씨드비,씨드비 프리미엄 물염색 3종 중 택 1,17000,13600,953,3400,20.0,1074
츠바키,츠바키 프리미엄 리페어 워터 더블기획 (220ml +220ml),26600,21200,999,5400,20.3,1075
온더바디,온더바디 퓨어시카 쉐어 바디워시 1000ml 2종 택1,14900,8900,999,6000,40.3,1076
네이밍,네이밍 플러피 파우더 블러쉬 7colors,15000,13500,999,1500,10.0,1077
포인트앤,[버니키링 증정] 포인트앤 딥멜팅 소이 클렌징 밤 90ml,17900,13400,256,4500,25.1,1078
컬러그램,컬러그램 쥬시 퐁당 틴트 8종,9800,8800,999,1000,10.2,1079
루나,루나 프로 포토 피니셔 블러 파우더,28000,21000,999,7000,25.0,1080
아크네스,아크네스 퍼펙트 솔루션 바디워시 더블 기획 (500ml+500ml),28000,21000,999,7000,25.0,1081
마몽드,[대용량] 마몽드 로즈 워터 토너 500ml,30000,21000,999,9000,30.0,1082
커리쉴,[1월올영픽/실키오일세럼13ml증정]커리쉴 에프터 살롱 케어 헤어팩 트리트먼트 250ml,28000,21000,999,7000,25.0,1083
유기농본,유기농본생리대 팬티라이너 롱 14개입,2400,1900,397,500,20.8,1084
글램팜,[서강준 PICK] 글램팜 컴팩트 미니고데기 2종 택1,84000,82000,14,2000,2.4,1085
헉슬리,헉슬리 바디오일 100ml 2종 택1,45000,36000,999,9000,20.0,1086
유세린,유세린 하이알루론 부스팅에센스 100ml,48000,36000,533,12000,25.0,1087
아떼,아떼 바이탈 씨 좀 토닝 컨센트레이트 기획(20ml+10ml*2ea),45000,36000,287,9000,20.0,1088
에스트라,에스트라 리제덤365 모공탄력 캡슐세럼 30ml,48000,36000,999,12000,25.0,1089
피카소,피카소 윤기창조 FB17 파운데이션 브러쉬 기획(단독증정),57000,35060,787,21940,38.5,1090
비욘드,비욘드 엔젤아쿠아 보습장벽크림 150ml 1+1기획 (비건),25000,20800,753,4200,16.8,1091
에스쁘아,[세레나데 재출시] 에스쁘아 더슬릭 립스틱 크림매트 7colors,26000,20800,999,5200,20.0,1092
브링그린,브링그린 대나무히알루수분크림75mL더블기획_NEW,34200,20800,999,13400,39.2,1093
에뛰드,[조효진개발] 에뛰드 그림자 쉐딩 브러쉬 3종 택1,5000,4500,999,500,10.0,1094
코스알엑스,[화해1위] 코스알엑스 더 레티놀 0.1 크림 20ml,25000,20700,746,4300,17.2,1095
좋은느낌,좋은느낌 유기농 탐폰 2종 택 1 (레귤러 / 슈퍼 12P),10800,8600,151,2200,20.4,1096
피카소,피카소 195 컨실러 브러쉬,29000,20670,70,8330,28.7,1097
소프리스,소프리스 발뒤꿈치만 집중필링 마스크,3800,3400,999,400,10.5,1098
브링그린,[백현 PICK] 브링그린 티트리시카포어코팩 3매입,7900,5510,999,2390,30.3,1099
딜라이트 프로젝트,[온라인단독]딜라이트 프로젝트 곤약워터젤리 10개입 2종 택 1,19000,8500,369,10500,55.3,1100
피캄,피캄 베리어 사이클 락토P 토너200ml 기획(+화장솜 증정),23000,20500,999,2500,10.9,1101
비비랩,[1월 올영픽]비비랩 석류콜라겐S 14포 (2주분),25900,12900,999,13000,50.2,1102
미쟝센,[NEW] 미쟝센 퍼펙트 노 워시 트리트먼트 미스트 250ml 대용량,19900,12900,999,7000,35.2,1103
브링그린,[NEW] 브링그린 티트리 시카 포어 클레이팩 스트롱 100g,19000,12900,6,6100,32.1,1104
닥터자르트,닥터자르트 더마스크 워터젯 바이탈 하이드라 솔루션,6500,3250,999,3250,50.0,1105
보다나,보다나 컴팩트 판고데기 28mm 파우더블루,39600,35200,57,4400,11.1,1106
이너시아,이너시아 더 프리즘 유기농 생리대 7종 택 1,8500,8100,999,400,4.7,1107
필리밀리,[NEW] 필리밀리S 풀커버파운데이션브러시825,22500,20250,15,2250,10.0,1108
투쿨포스쿨,투쿨포스쿨 바이로댕 헤어 쉐이딩 (본품+퍼프+브러쉬),16000,12800,999,3200,20.0,1109
에뛰드,에뛰드 팡팡 헤어 섀도우 3.5G [다크브라운/라이트브라운/블랙] 3종 택1,16000,12800,999,3200,20.0,1110
식물나라,[NEW] 식물나라 뽀얀쌀 맑은톤 클리어패드 100매,19800,12800,173,7000,35.4,1111
티원콜라겐,[단독기획] 티원콜라겐 프리미엄 블랙 기획 (본품+파우치2장+스파출러),38500,35100,140,3400,8.8,1112
메디큐브,메디큐브 레드 이레이징 크림 2.0 50ml,25200,20200,130,5000,19.8,1113
아임오,아임오 유기농 생리대 3팩 5종 택 1(라이너 / 소 / 중 / 대 / 오버나이트),13200,8500,136,4700,35.6,1114
페리페라,[기획] 페리페라 잉크올블랙카라 (1+1) 기획세트,15000,12750,999,2250,15.0,1115
닥터디퍼런트,[올영단독] 닥터디퍼런트 비타리프트 에이 포르테 더블 기획,93600,79560,999,14040,15.0,1116
테라브레스,테라브레스 마우스 로젠지 캔디 만다린민트향 100개입,22900,20100,626,2800,12.2,1117
블리스텍스,[NEW] 블리스텍스 딥리뉴얼 립밤 3.7g,5500,3140,999,2360,42.9,1118
민티드,민티드 프리미엄 고체치약 2종 택1 (90정/180정),11900,10900,424,1000,8.4,1119
파파레서피,파파레서피 가지 클리어링 수분 각질 필링 패드 토너 70매,25000,20000,228,5000,20.0,1120
비레디,비레디 블루 수분 선크림 50ml 기획세트 (+20ml 증정),25000,20000,167,5000,20.0,1121
헉슬리,헉슬리 퍼퓸 샤쉐 모로칸 가드너 20g,21000,19950,129,1050,5.0,1122
필리밀리,필리밀리 비건페이스타월,5500,5200,956,300,5.5,1123
메이크힐,메이크힐 원피엘 파운데이저 파운데이션 28g,30000,19900,517,10100,33.7,1124
폰즈,폰즈 클리어 스파 립앤아이 리무버 300ml,24500,12500,999,12000,49.0,1125
리쥬란,[광노화케어_신소재적용] 리쥬란 바이옴 힐러 유스 포뮬러 크림 50ml,49000,34500,174,14500,29.6,1126
아이소이,[응급스팟] 아이소이 아크니닥터 1st 스피디 스팟 14ml 기획 (14ml+응급패드 4매),24800,19800,999,5000,20.2,1127
마르시끄,마르시끄 인리치드 비건 블랙 속눈썹 영양제,24800,19800,801,5000,20.2,1128
런드리유,[단독기획]런드리유 클린 페이스 가글 스트롱 젤 투 폼 클렌저 기획세트,22000,19800,999,2200,10.0,1129
라네즈,라네즈옴므 액티브워터 2종 기획 (미니어처 3종 포함),53000,34450,638,18550,35.0,1130
인클리어,[의료기기] 렛츠인클리어 질세정기 2종 택1 (렛츠인클리어 2P / 렛츠인클리어 9P),8000,6900,999,1100,13.8,1131
티젠,티젠 콤부차 10+5T 어워즈 한정기획 (2023) 2종 택1,7500,5100,474,2400,32.0,1132
박준뷰티랩,[대용량]박준뷰티랩 아르간 샴푸 1150ml,13800,12400,999,1400,10.1,1133
비오템 옴므,비오템옴므 아쿠아파워 어드밴스드 젤 로션 100ML,92000,78200,45,13800,15.0,1134
포맨트,포맨트 히든 립밤 3.6g,8900,8000,601,900,10.1,1135
메이블린,메이블린뉴욕 스카이하이 마스카라,19000,12350,999,6650,35.0,1136
르멘트,[모하비PICK] 르멘트 컬러 네일 31종 & 다즐링 하드너,15000,12000,999,3000,20.0,1137
미샤,미샤 비타씨플러스 잡티씨 탄력 앰플 40ml,28000,19600,999,8400,30.0,1138
라운드랩,[NEW] 라운드랩 소나무 진정 시카 앰플 기획 (+진정 크림 10ml 증정),24000,19600,999,4400,18.3,1139
타입넘버,타입넘버 핸드크림 40ml 5종 택 1,12000,10800,999,1200,10.0,1140
폰즈,[1월 올영픽 / 리무버&클렌징폼 증정] 폰즈 클리어 스파 피부 청정 클렌징 오일 200ml 기획세트,18900,12300,60,6600,34.9,1141
에스쁘아,에스쁘아 노머징 마스카라 워터프루프 XP,23000,19550,900,3450,15.0,1142
VDL,VDL 치크스테인 블러셔,23000,19550,654,3450,15.0,1143
에치와이,에치와이 갓비움 야쿠르트 100ml,3900,2920,941,980,25.1,1144
삐아,[NEW리본에디션] 삐아 로 틴트,16000,12260,999,3740,23.4,1145
에르고바디,에르고바디 소프디 풋파일 듀오 기획,23000,19500,999,3500,15.2,1146
크리니크,크리니크 래쉬 파워 컬링 마스카라 01 블랙 오닉스,40000,34000,37,6000,15.0,1147
푸드올로지,[봉선 PiCK] 톡스올로지 클렌즈 비움 50ml*6병+1병 증정 기획,22900,19470,902,3430,15.0,1148
더블유드레스룸,W.DRESSROOM 드레스퍼퓸 시즌3 80ml/160ml 6종 택1,6900,4950,756,1950,28.3,1149
겐조,[NEW] 라 컬렉션 겐조 메모리 시엘 매그놀리아 EDP 75ml,129000,77400,30,51600,40.0,1150
클리너리,클리너리 오라밸런스 덴탈케어 30정,39800,33900,40,5900,14.8,1151
다슈,[2023 어워즈] 다슈 클래식 스타일 그루밍 토닉 200ml 어워즈 한정기획 (본품+그루밍 토닉 100ml+메가 홀드,18000,12160,999,5840,32.4,1152
웨이크메이크,[NEW] 웨이크메이크 파운데이션 브러시 3종 (기획/와이드/퍼프핏),20000,18000,607,2000,10.0,1153
에스트라,에스트라 리제덤365 밀도탄력 캡슐크림 50ml,45000,33700,920,11300,25.1,1154
카밀,"[림PICK] 카밀 비건 립밤 택1 ( 클래식, 자몽, 피치) 4.2g",7200,4860,999,2340,32.5,1155
닥터트웬티프로젝트,닥터트웬티프로젝트 리프덤 오토 아이크림20ml,42000,33600,355,8400,20.0,1156
라운드랩,[NEW] 라운드랩 약콩 판테놀 크림 80ml 1+1 기획,34000,33600,743,400,1.2,1157
빼바,[성해은PICK/노슈가 프로틴바] 빼바 리얼초콜릿 프로틴바 40g 1BOX(9개입) 2종 택1 (다크/화이트),24000,19200,999,4800,20.0,1158
넥스케어,[OY단독]넥스케어 블레미쉬 패치 케어 63+48매 기획팩,9600,7700,999,1900,19.8,1159
에스티로더,"에스티 로더 더블웨어 파운데이션 기획(+펌핑기, 갈색병 세럼 7ml 증정)/단품 택1",87000,73950,999,13050,15.0,1160
벨먼,벨먼 내추럴 스파 수분광채 스크럽워시 400ml 6종 택 1,12900,11900,999,1000,7.8,1161
AHC,AHC 에센스케어 클렌징오일 에메랄드 125ml,19000,11900,168,7100,37.4,1162
페리오,페리오 화이트나우 미백패치 택1 (일주일팩 14P / 8P*8 (64입)),21000,11900,999,9100,43.3,1163
grn+,grn+ 갈색이 효소 14포 (14일분),16000,11900,924,4100,25.6,1164
아비노,[NEW] 아비노 스킨 릴리프 핸드크림 100g,10900,7600,999,3300,30.3,1165
라운드어라운드,라운드어라운드 그린티 트러블 버블 폼 200ml 리필 기획세트,28800,19000,999,9800,34.0,1166
라로슈포제,라로슈포제 NEW 시카플라스트밤B5+ 100ml,39000,33150,999,5850,15.0,1167
베러데이,베러데이 키즈데이 포도맛 츄어블(종합비타민) 90정(30일분),36000,33150,8,2850,7.9,1168
베러데이,베러데이 키즈데이 칼마디 초코맛 120정(30일분),36000,33150,14,2850,7.9,1169
식물나라,식물나라 산소수 가벼운 수분 선젤로션 SPF50+PA++++,14800,11800,999,3000,20.3,1170
식물나라,식물나라 산소수워터프루프선크림(대용량) 100mL,19000,11800,999,7200,37.9,1171
브링그린,[백현 PICK] 브링그린 티트리시카센시티브클렌징워터500mL_NEW,16000,11800,503,4200,26.2,1172
커리쉴,커리쉴 모이스처 글로우 헤어 에센스 70ml,21000,18900,999,2100,10.0,1173
에스네이처,[화해수상] 에스네이처 블랑쉬 클렌저 260ml,26000,18900,176,7100,27.3,1174
에스네이처,[화해1위] 에스네이처 아쿠아 오아시스 토너 300ml,24000,18900,999,5100,21.2,1175
일리윤,[1월 올영픽] 일리윤 MD 레드이치 오일 200ML 기획(크림 30ML 증정),24000,18900,827,5100,21.2,1176
